id_distribuidor,folio,saldo_vencido_total,pagos_vencidos,creditos_totales,creditos_con_claves_prevencion,creditos_completados_con_atraso,creditos_completados_sin_atraso
100002,1063536978,36135.0,58.0,57,14,6,51
100011,1063538099,140873.0,56.0,15,11,3,12
100016,1063538095,188754.0,78.0,18,9,4,14
100025,1063536998,1587.0,17.0,17,9,1,16
100030,1063537106,12323.0,44.0,62,30,2,60
100037,1063537665,25718.0,86.0,17,5,2,15
100040,1063537661,277182.0,154.0,82,62,7,75
100041,1063537642,187441.0,74.0,35,22,3,32
100042,1063537656,28304.0,63.0,12,7,4,8
100043,1063538092,41251.0,92.0,20,10,3,17
100055,1063537047,117498.0,261.0,46,28,16,30
100064,1063538089,129513.0,280.0,106,29,13,93
100078,1063537068,0.0,0.0,11,6,0,11
100080,1063537096,42009.0,205.0,57,35,3,54
100082,1063537845,0.0,10.0,9,0,0,9
100085,1063537839,33690.0,180.0,33,7,9,24
100087,1063537408,123186.0,213.0,111,36,8,103
100088,1063537834,82171.0,205.0,15,6,9,6
100089,1063537402,17560.0,49.0,52,33,4,48
100090,1063537400,12443.0,43.0,20,11,5,15
100094,1063537396,131306.0,122.0,83,45,7,76
100096,1063537831,0.0,9.0,28,22,0,28
100108,1063537770,16572.0,257.0,28,5,5,23
100111,1063537423,93599.0,224.0,54,40,9,45
100124,1063537389,136089.0,181.0,58,31,8,50
100128,1063537501,0.0,0.0,1,0,0,1
100151,1063537766,47718.0,109.0,54,4,15,39
100153,1063537763,32138.0,115.0,49,4,6,43
100191,1063538507,0.0,25.0,132,14,0,132
100228,1063538086,95131.0,33.0,26,12,4,22
100244,1063538084,149692.0,39.0,47,22,3,44
100246,1063537757,30102.0,304.0,32,3,10,22
100270,1063537066,31177.0,51.0,29,16,2,27
100273,1063538029,321332.0,489.0,95,67,12,83
100274,1063536903,35653.0,5.0,15,7,1,14
100276,1063538024,38669.0,32.0,15,10,4,11
100278,1063536898,57226.0,162.0,51,31,7,44
100279,1063538017,15444.0,54.0,32,25,5,27
100280,1063536896,50766.0,43.0,46,33,4,42
100282,1063538013,44365.0,188.0,63,41,8,55
100287,1063536894,49196.0,168.0,50,34,4,46
100289,1063536885,15124.0,44.0,27,19,2,25
100290,1063536883,35653.0,5.0,18,11,1,17
100292,1063536880,0.0,3.0,24,21,0,24
100297,1063537226,46231.0,97.0,42,23,6,36
100301,1063537217,62100.0,42.0,64,30,6,58
100308,1063537211,53616.0,89.0,60,25,8,52
100309,1063537385,23591.0,21.0,10,8,3,7
100330,1063538721,32067.0,73.0,34,12,4,30
100337,1063538717,0.0,4.0,13,9,0,13
100339,1063537544,38345.0,39.0,20,11,4,16
100342,1063538715,0.0,9.0,7,1,0,7
100423,1063537998,121327.0,127.0,64,42,5,59
100436,1063537992,90134.0,19.0,28,16,2,26
100437,1063540326,39050.0,364.0,52,21,5,47
100440,1063538387,29811.0,23.0,27,19,2,25
100444,1063537851,0.0,0.0,2,1,0,2
100445,1063537990,111830.0,101.0,123,69,7,116
100464,1063537981,114010.0,143.0,77,45,5,72
100471,1063537184,22157.0,45.0,32,15,4,28
100474,1063537380,15625.0,70.0,86,36,3,83
100481,1063538706,112504.0,138.0,72,57,5,67
100482,1063538714,0.0,2.0,1,0,0,1
100483,1063538702,87814.0,69.0,58,36,5,53
100485,1063537368,22578.0,89.0,9,5,3,6
100487,1063538692,150.0,65.0,26,15,2,24
100488,1063540031,8598.0,55.0,76,60,3,73
100510,1063537742,96415.0,137.0,67,44,6,61
100511,1063538686,178098.0,246.0,57,49,8,49
100513,1063538683,10314.0,31.0,23,18,2,21
100514,1063538675,115100.0,136.0,98,39,4,94
100520,1063538671,45044.0,233.0,73,45,6,67
100534,1063537736,19433.0,70.0,21,11,4,17
100541,1063537739,46910.0,154.0,152,11,11,141
100542,1063540026,28064.0,51.0,61,46,3,58
100543,1063537969,100143.0,34.0,17,12,3,14
100545,1063537691,18976.0,32.0,41,26,6,35
100546,1063537357,106008.0,188.0,65,27,8,57
100556,1063537538,34476.0,11.0,22,16,1,21
100558,1063538010,689.0,11.0,29,21,1,28
100560,1063537710,521.0,73.0,21,3,1,20
100561,1063537910,27705.0,75.0,11,7,6,5
100562,1063537904,51986.0,64.0,34,16,4,30
100565,1063537696,15123.0,199.0,19,10,3,16
100566,1063537898,23897.0,22.0,10,6,3,7
100572,1063537531,24608.0,77.0,6,2,4,2
100574,1063547766,3224.0,57.0,18,11,4,14
100575,1063537524,19520.0,24.0,8,3,5,3
100576,1063537894,23328.0,198.0,86,57,8,78
100578,1063537566,12704.0,3.0,21,11,1,20
100602,1063537174,96372.0,78.0,22,13,7,15
100609,1063538151,25840.0,110.0,21,12,5,16
100617,1063537498,38449.0,81.0,10,1,8,2
100622,1063538979,57627.0,27.0,7,3,3,4
100638,1063538977,70293.0,50.0,23,14,4,19
100641,1063537454,48619.0,22.0,26,10,3,23
100643,1063538975,167482.0,293.0,61,19,8,53
100645,1063538969,98869.0,49.0,22,14,5,17
100651,1063537604,17977.0,73.0,17,12,4,13
100667,1063537964,7964.0,90.0,20,15,5,15
100668,1063537706,14562.0,42.0,18,5,3,15
100671,1063537734,5203.0,12.0,8,2,2,6
100682,1063538132,34646.0,126.0,14,8,3,11
100694,1063538068,2127.0,33.0,9,3,1,8
100697,1063538072,38625.0,2.0,7,0,1,6
100719,1063542807,22097.0,198.0,99,35,16,83
100725,1063538126,34900.0,29.0,40,26,1,39
100755,1063538155,7263.0,72.0,11,8,1,10
100760,1063538261,30911.0,92.0,52,19,6,46
100767,1063537735,51745.0,142.0,17,10,8,9
100815,1063538656,23735.0,52.0,5,3,4,1
100817,1063538144,0.0,4.0,12,8,0,12
100838,1063538254,15835.0,82.0,18,7,3,15
100858,1063538002,20314.0,141.0,65,38,10,55
100884,1063537915,0.0,0.0,8,6,0,8
100897,1063538063,7916.0,236.0,56,32,3,53
100916,1063538120,38023.0,71.0,37,16,2,35
100921,1063538383,8449.0,11.0,44,27,1,43
100927,1063538057,12360.0,52.0,6,3,3,3
100934,1063537848,57666.0,117.0,12,5,6,6
100982,1063538308,0.0,5.0,58,22,0,58
100984,1063538306,2647.0,4.0,28,5,1,27
100985,1063538293,19161.0,97.0,82,44,2,80
100987,1063537952,15051.0,31.0,47,17,2,45
100988,1063538304,12410.0,21.0,27,19,2,25
100990,1063538289,0.0,10.0,20,11,0,20
100992,1063538102,2275.0,8.0,70,26,1,69
101003,1063538370,37938.0,127.0,44,21,4,40
101006,1063537945,0.0,6.0,16,1,0,16
101007,1063537944,1485.0,7.0,7,0,2,5
101012,1063537938,0.0,4.0,4,0,0,4
101014,1063537935,24868.0,148.0,57,21,4,53
101037,1063538053,40850.0,103.0,63,50,4,59
101041,1063538044,10059.0,23.0,4,1,2,2
101045,1063537932,58786.0,117.0,44,14,6,38
101050,1063538365,48277.0,159.0,92,73,9,83
101062,1063537930,0.0,0.0,1,0,0,1
101063,1063538341,40866.0,129.0,96,77,9,87
101065,1063538333,39144.0,107.0,68,58,6,62
101066,1063539024,6805.0,15.0,84,36,1,83
101070,1063539013,194080.0,73.0,46,23,8,38
101071,1063539007,7597.0,30.0,38,27,2,36
101080,1063538035,0.0,99.0,9,3,0,9
101083,1063538894,68704.0,97.0,45,35,6,39
101084,1063538881,16423.0,31.0,19,11,2,17
101088,1063538234,0.0,7.0,7,4,0,7
101090,1063538227,5159.0,257.0,22,5,7,15
101091,1063538653,54900.0,137.0,61,45,8,53
101092,1063538860,38222.0,113.0,7,2,2,5
101094,1063538854,73145.0,294.0,258,27,7,251
101096,1063538845,18504.0,126.0,62,9,18,44
101133,1063539094,62597.0,137.0,73,47,3,70
101142,1063539096,37481.0,155.0,24,15,5,19
101143,1063538117,0.0,0.0,3,2,0,3
101149,1063538272,38822.0,85.0,66,45,5,61
101151,1063538285,97205.0,135.0,154,112,3,151
101164,1063538179,6515.0,25.0,4,1,2,2
101181,1063538178,4382.0,38.0,8,4,2,6
101182,1063538176,34476.0,46.0,29,3,3,26
101204,1063539664,95448.0,103.0,131,77,7,124
101208,1063538484,67250.0,106.0,52,32,7,45
101209,1063538327,25216.0,87.0,80,60,6,74
101211,1063538480,61510.0,159.0,30,18,9,21
101212,1063538476,62019.0,250.0,34,20,5,29
101214,1063538960,82075.0,18.0,29,9,2,27
101215,1063538463,77593.0,58.0,26,9,3,23
101216,1063539269,36883.0,63.0,52,40,5,47
101219,1063538461,33575.0,123.0,37,22,4,33
101220,1063538948,56693.0,50.0,17,13,4,13
101228,1063539267,15954.0,23.0,7,3,2,5
101250,1063538843,56244.0,62.0,21,11,2,19
101265,1063538577,6534.0,52.0,21,15,4,17
101269,1063538322,11090.0,43.0,14,5,3,11
101270,1063539263,388.0,10.0,2,1,1,1
101273,1063538309,13690.0,23.0,35,26,2,33
101286,1063538572,43914.0,231.0,40,17,4,36
101289,1063538567,36055.0,338.0,43,27,6,37
101291,1063538566,25874.0,154.0,22,10,3,19
101292,1063538664,40699.0,102.0,60,42,3,57
101293,1063538560,28957.0,91.0,16,5,5,11
101294,1063538558,0.0,0.0,4,2,0,4
101298,1063538273,112217.0,178.0,57,33,7,50
101301,1063538280,23311.0,75.0,27,23,1,26
101304,1063538448,88815.0,188.0,51,33,5,46
101307,1063539710,4694.0,70.0,32,26,2,30
101308,1063538799,58807.0,93.0,57,29,4,53
101314,1063538792,44650.0,134.0,91,11,9,82
101315,1063538753,81517.0,57.0,28,21,5,23
101320,1063538790,6150.0,66.0,27,8,1,26
101329,1063538114,6984.0,45.0,18,12,3,15
101336,1063538999,18078.0,30.0,6,3,4,2
101349,1063547770,37333.0,44.0,27,17,3,24
101350,1063538788,508257.0,424.0,69,32,13,56
101355,1063538836,52415.0,111.0,35,21,5,30
101357,1063538833,26011.0,30.0,8,3,1,7
101358,1063538822,57289.0,72.0,30,16,5,25
101360,1063538818,26011.0,19.0,11,3,1,10
101373,1063538104,49084.0,192.0,42,25,5,37
101374,1063538749,28532.0,28.0,6,2,3,3
101376,1063539654,87155.0,96.0,35,22,4,31
101379,1063538785,14809.0,50.0,79,13,11,68
101389,1063538748,7080.0,70.0,20,18,2,18
101401,1063538782,6150.0,11.0,27,11,1,26
101432,1063538213,70933.0,92.0,49,15,4,45
101442,1063538740,0.0,0.0,5,2,0,5
101445,1063538220,528.0,71.0,13,1,2,11
101446,1063538442,11551.0,16.0,35,22,2,33
101448,1063538435,1750.0,226.0,67,33,1,66
101449,1063538427,240.0,11.0,29,21,1,28
101450,1063538419,36264.0,51.0,77,27,5,72
101453,1063538414,0.0,0.0,1,0,0,1
101456,1063538410,13608.0,119.0,14,3,9,5
101503,1063538988,2459.0,90.0,37,7,1,36
101522,1063539087,42730.0,21.0,41,24,2,39
101523,1063539079,69831.0,119.0,93,52,10,83
101537,1063538732,9399.0,74.0,10,8,1,9
101539,1063538722,7532.0,60.0,13,9,3,10
101619,1063538776,70710.0,153.0,55,18,9,46
101620,1063539061,57998.0,134.0,16,7,5,11
101624,1063539058,931.0,71.0,7,5,1,6
101630,1063538711,145949.0,17.0,9,3,3,6
101642,1063538773,40219.0,37.0,59,37,2,57
101656,1063539045,69876.0,93.0,7,5,3,4
101657,1063538769,18835.0,17.0,13,6,3,10
101665,1063538762,121906.0,109.0,37,19,5,32
101668,1063538756,6150.0,11.0,17,11,1,16
101670,1063539360,33166.0,47.0,35,30,3,32
101674,1063538910,55728.0,126.0,44,13,3,41
101683,1063538932,11771.0,200.0,13,7,6,7
101690,1063539106,24040.0,49.0,26,16,4,22
101696,1063538497,0.0,12.0,36,14,0,36
101697,1063538645,6608.0,8.0,20,12,3,17
101698,1063538908,53759.0,131.0,26,18,4,22
101701,1063538644,2589.0,83.0,26,5,3,23
101703,1063538631,2398.0,12.0,37,8,1,36
101708,1063538625,223974.0,276.0,69,35,6,63
101711,1063538606,18402.0,57.0,41,26,5,36
101725,1063539190,108629.0,194.0,39,16,11,28
101727,1063538897,84105.0,118.0,59,22,10,49
101734,1063538876,87748.0,289.0,32,9,22,10
101741,1063538553,4024.0,44.0,90,48,1,89
101742,1063538542,27406.0,54.0,27,16,4,23
101747,1063539738,39557.0,47.0,65,25,4,61
101755,1063538281,25064.0,222.0,33,24,6,27
101759,1063538857,110626.0,36.0,45,32,3,42
101820,1063539358,12128.0,126.0,14,7,7,7
101875,1063539225,31480.0,99.0,969,11,7,962
101885,1063539249,24642.0,127.0,42,29,3,39
101887,1063539243,12167.0,116.0,30,11,6,24
101888,1063539241,0.0,24.0,7,1,0,7
101889,1063539236,9796.0,37.0,39,29,2,37
101890,1063539232,72989.0,179.0,22,7,16,6
101894,1063539623,17901.0,83.0,43,22,3,40
101902,1063539629,128028.0,211.0,60,33,7,53
101904,1063539645,44451.0,47.0,53,29,3,50
101913,1063539635,120001.0,247.0,59,9,6,53
101944,1063538848,125434.0,46.0,42,27,4,38
101960,1063538844,273.0,4.0,20,9,1,19
101961,1063538839,1441.0,15.0,31,23,2,29
101979,1063539349,29464.0,181.0,18,7,13,5
102004,1063539104,7349.0,8.0,56,22,3,53
102062,1063539108,17829.0,25.0,43,13,3,40
102068,1063538608,0.0,1.0,14,8,0,14
102079,1063539792,12422.0,9.0,32,18,2,30
102081,1063539345,68417.0,110.0,16,4,7,9
102086,1063539789,3456.0,56.0,29,1,7,22
102087,1063547155,41558.0,132.0,37,18,11,26
102090,1063538918,16387.0,520.0,43,12,8,35
102093,1063539092,60540.0,94.0,69,38,4,65
102095,1063539076,77713.0,163.0,81,44,6,75
102131,1063539219,12283.0,8.0,3,2,2,1
102145,1063539128,31729.0,154.0,39,14,8,31
102149,1063539141,29982.0,21.0,65,36,2,63
102150,1063539511,169.0,5.0,31,19,1,30
102151,1063539503,82422.0,172.0,120,94,10,110
102153,1063539489,23837.0,8.0,57,37,2,55
102158,1063539485,5940.0,26.0,117,83,1,116
102199,1063539167,48799.0,97.0,32,18,5,27
102211,1063538810,227330.0,250.0,65,31,12,53
102212,1063538986,3800.0,12.0,42,13,1,41
102216,1063539175,39138.0,23.0,23,20,4,19
102242,1063539341,0.0,5.0,8,2,0,8
102250,1063539195,90760.0,87.0,68,45,7,61
102254,1063539125,59914.0,58.0,84,23,6,78
102264,1063539300,0.0,0.0,2,0,0,2
102267,1063539298,0.0,15.0,13,3,0,13
102268,1063539297,215162.0,99.0,13,3,4,9
102272,1063539291,8818.0,30.0,16,7,6,10
102293,1063538805,67899.0,102.0,47,30,5,42
102295,1063539145,4452.0,5.0,9,5,1,8
102296,1063539149,8279.0,20.0,61,11,1,60
102309,1063539155,0.0,3.0,47,26,0,47
102351,1063539035,418.0,6.0,25,18,1,24
102352,1063539215,21821.0,19.0,5,2,2,3
102355,1063539206,6687.0,64.0,8,1,2,6
102357,1063539284,43043.0,266.0,17,8,4,13
102358,1063539030,12544.0,16.0,5,2,1,4
102360,1063538991,42445.0,100.0,24,17,4,20
102365,1063539260,46794.0,52.0,45,28,4,41
102370,1063539326,25626.0,45.0,7,3,6,1
102374,1063539254,13134.0,44.0,40,18,3,37
102378,1063539316,11787.0,40.0,20,17,3,17
102382,1063539309,71737.0,147.0,20,8,11,9
102414,1063539734,11007.0,67.0,18,6,1,17
102442,1063539121,3087.0,27.0,17,16,1,16
102461,1063539733,20273.0,54.0,14,10,5,9
102466,1063539701,40176.0,64.0,26,7,4,22
102467,1063539696,83361.0,108.0,12,9,6,6
102469,1063539673,60.0,2.0,12,8,1,11
102478,1063539670,19407.0,101.0,19,16,2,17
102479,1063539691,55494.0,66.0,32,15,5,27
102485,1063539304,22686.0,85.0,20,14,6,14
102488,1063539690,61202.0,104.0,98,57,9,89
102490,1063539682,91870.0,445.0,76,31,16,60
102495,1063539680,51212.0,36.0,54,36,3,51
102497,1063539675,110986.0,210.0,61,49,6,55
102521,1063539162,3132.0,9.0,46,28,1,45
102582,1063539334,40606.0,262.0,78,41,7,71
102602,1063539100,45531.0,51.0,15,2,2,13
102603,1063539303,27739.0,35.0,15,10,2,13
102615,1063539274,10362.0,99.0,25,15,4,21
102621,1063539638,148189.0,105.0,47,29,7,40
102635,1063539118,43853.0,47.0,53,38,2,51
102691,1063539652,6283.0,73.0,9,3,3,6
102692,1063539646,25224.0,77.0,57,22,5,52
102714,1063539473,24232.0,36.0,112,93,4,108
102718,1063540092,0.0,7.0,6,0,0,6
102725,1063539592,56925.0,155.0,59,44,10,49
102727,1063539927,19140.0,22.0,18,10,2,16
102733,1063539587,1230.0,23.0,15,13,1,14
102735,1063539582,5118.0,75.0,111,83,5,106
102739,1063539572,8242.0,21.0,38,22,1,37
102741,1063539562,25070.0,65.0,18,7,4,14
102745,1063539560,8724.0,33.0,27,15,3,24
102770,1063539551,7534.0,18.0,34,9,2,32
102774,1063539548,0.0,9.0,9,2,0,9
102775,1063539466,503.0,28.0,82,54,1,81
102776,1063539454,1507.0,27.0,21,8,1,20
102779,1063539449,21174.0,148.0,81,15,7,74
102782,1063543587,24546.0,35.0,35,18,4,31
102784,1063539542,80759.0,258.0,104,56,12,92
102785,1063539724,46131.0,79.0,15,7,4,11
102786,1063539444,16185.0,173.0,63,32,5,58
102788,1063539914,29336.0,20.0,12,2,1,11
102791,1063539377,0.0,0.0,7,3,0,7
102792,1063539374,0.0,7.0,314,43,0,314
102793,1063539369,871.0,2.0,15,9,1,14
102794,1063539366,241810.0,223.0,90,35,16,74
102822,1063539540,39.0,81.0,70,50,1,69
102832,1063539428,32238.0,139.0,26,17,4,22
102834,1063539713,6426.0,27.0,33,15,2,31
102835,1063539421,25444.0,59.0,27,17,5,22
102865,1063539363,12962.0,16.0,31,12,6,25
102881,1063539642,38392.0,112.0,56,35,12,44
102882,1063539437,29268.0,107.0,52,38,7,45
102888,1063539639,4044.0,21.0,8,3,1,7
102896,1063539783,74631.0,235.0,71,43,12,59
102897,1063539386,796.0,39.0,84,49,2,82
102901,1063539611,4478.0,23.0,54,21,2,52
102927,1063539524,1060.0,43.0,13,7,2,11
102935,1063539522,39798.0,172.0,10,5,5,5
102937,1063539515,917.0,107.0,5,3,1,4
102961,1063539536,25744.0,88.0,55,24,4,51
102972,1063539407,0.0,2.0,9,6,0,9
102973,1063539965,13547.0,104.0,50,32,4,46
102976,1063539393,17043.0,59.0,14,6,3,11
102977,1063539605,3520.0,13.0,36,23,1,35
102979,1063540075,8929.0,20.0,10,5,3,7
102982,1063539389,846.0,22.0,12,8,1,11
102986,1063539771,45982.0,51.0,41,31,6,35
103061,1063540022,7126.0,32.0,12,8,3,9
103068,1063540015,40865.0,130.0,45,34,7,38
103107,1063539514,47309.0,61.0,21,12,5,16
103146,1063539765,123130.0,224.0,82,27,7,75
103156,1063539757,0.0,0.0,11,9,0,11
103159,1063539752,75790.0,129.0,45,29,4,41
103220,1063539767,3503.0,7.0,3,2,1,2
103261,1063540763,59972.0,189.0,129,100,10,119
103298,1063539747,0.0,0.0,15,1,0,15
103314,1063539744,7731.0,49.0,18,15,3,15
103477,1063540001,5226.0,76.0,54,24,3,51
103486,1063542014,47278.0,42.0,28,15,5,23
103501,1063539992,0.0,0.0,4,1,0,4
103503,1063539981,6560.0,16.0,23,6,1,22
103505,1063539974,4110.0,103.0,22,15,1,21
103517,1063539812,4927.0,100.0,13,2,5,8
103543,1063539911,49421.0,172.0,33,20,6,27
103576,1063539856,0.0,2.0,50,11,0,50
103581,1063539849,33160.0,25.0,8,5,1,7
103616,1063539800,0.0,18.0,4,2,0,4
103668,1063539795,0.0,0.0,2,1,0,2
103697,1063539839,19655.0,278.0,69,37,5,64
103763,1063539864,119660.0,281.0,90,51,11,79
103766,1063540734,119516.0,169.0,61,39,10,51
103768,1063539861,11295.0,10.0,7,0,2,5
103769,1063539968,10691.0,97.0,20,5,4,16
103771,1063539823,9118.0,5.0,58,46,1,57
103808,1063540107,20351.0,49.0,8,2,2,6
103824,1063539830,12772.0,119.0,34,25,4,30
103826,1063539822,24012.0,57.0,28,13,2,26
103858,1063540174,13188.0,53.0,20,16,4,16
103865,1063539905,18828.0,9.0,6,4,1,5
103866,1063539902,48608.0,27.0,7,5,2,5
103868,1063539900,85006.0,126.0,31,16,9,22
103869,1063539891,18596.0,31.0,12,4,2,10
103874,1063539949,3079.0,5.0,23,15,1,22
103876,1063539945,0.0,0.0,9,5,0,9
103879,1063545097,22019.0,62.0,141,9,3,138
103897,1063539938,12974.0,103.0,66,34,4,62
103914,1063540554,38787.0,138.0,53,13,6,47
103917,1063540551,16538.0,40.0,40,29,6,34
103920,1063540058,54483.0,104.0,50,42,6,44
103921,1063540542,11884.0,187.0,34,13,5,29
103929,1063540007,15383.0,178.0,33,25,4,29
103971,1063540187,0.0,52.0,81,44,0,81
104000,1063539888,7199.0,3.0,12,2,1,11
104050,1063540052,9580.0,11.0,57,20,4,53
104058,1063540047,0.0,11.0,8,4,0,8
104068,1063539857,8435.0,62.0,9,5,4,5
104081,1063540537,24634.0,94.0,60,33,3,57
104083,1063539931,122557.0,284.0,70,34,5,65
104116,1063540153,30369.0,159.0,54,39,6,48
104119,1063540143,30824.0,56.0,90,51,3,87
104121,1063540141,135250.0,143.0,131,70,11,120
104122,1063540118,126301.0,511.0,79,36,17,62
104136,1063540069,5615.0,82.0,29,5,2,27
104148,1063540731,11229.0,9.0,15,6,2,13
104151,1063540113,17295.0,44.0,93,45,4,89
104153,1063540720,68038.0,164.0,44,29,15,29
104154,1063540715,49476.0,52.0,100,55,7,93
104158,1063540713,39279.0,28.0,48,20,5,43
104159,1063540709,32950.0,50.0,38,24,4,34
104188,1063540103,612.0,39.0,38,12,1,37
104220,1063540267,156472.0,63.0,53,26,4,49
104225,1063540261,1982.0,270.0,473,17,1,472
104226,1063540066,95473.0,81.0,38,6,2,36
104227,1063541021,4615.0,53.0,12,10,2,10
104237,1063541018,14907.0,151.0,17,10,6,11
104264,1063540253,0.0,0.0,14,4,0,14
104266,1063540251,52173.0,61.0,75,48,4,71
104267,1063540385,4825.0,70.0,37,17,2,35
104269,1063540246,2026332.0,26.0,26,17,1,25
104276,1063540378,50178.0,125.0,59,42,8,51
104278,1063540243,13068.0,62.0,51,25,1,50
104283,1063540498,99759.0,279.0,35,22,12,23
104284,1063540237,0.0,4.0,29,12,0,29
104285,1063540611,11695.0,37.0,46,25,4,42
104304,1063540100,0.0,2.0,12,3,0,12
104305,1063540488,158021.0,162.0,24,12,4,20
104306,1063540605,31364.0,117.0,118,92,9,109
104307,1063540603,17788.0,67.0,77,55,5,72
104308,1063540231,92224.0,252.0,91,35,9,82
104311,1063540583,18129.0,34.0,66,48,2,64
104312,1063540164,743.0,138.0,17,9,1,16
104313,1063540580,12766.0,27.0,74,36,1,73
104316,1063540306,24095.0,65.0,76,44,6,70
104317,1063540158,0.0,0.0,1,0,0,1
104318,1063540297,19255.0,105.0,41,18,9,32
104322,1063540597,88813.0,138.0,96,72,8,88
104324,1063540369,22405.0,61.0,11,7,4,7
104325,1063540587,7865.0,37.0,21,10,4,17
104326,1063540362,27312.0,30.0,52,19,2,50
104330,1063540359,9216.0,11.0,15,8,1,14
104335,1063540352,45823.0,105.0,30,18,7,23
104359,1063540288,6937.0,52.0,23,12,2,21
104361,1063540277,34379.0,36.0,6,3,2,4
104382,1063540750,72285.0,933.0,34,25,13,21
104385,1063540746,8075.0,29.0,28,19,2,26
104390,1063540744,18599.0,35.0,12,4,4,8
104394,1063540740,2903.0,18.0,13,6,1,12
104398,1063545058,56510.0,150.0,49,12,10,39
104401,1063540483,140349.0,112.0,118,40,7,111
104402,1063540476,155707.0,282.0,50,27,13,37
104403,1063540227,42600.0,181.0,24,14,7,17
104411,1063540573,23695.0,34.0,48,37,5,43
104414,1063540225,188259.0,115.0,35,12,5,30
104415,1063540218,71137.0,115.0,78,47,8,70
104416,1063540215,40434.0,32.0,103,46,3,100
104431,1063540348,3944.0,30.0,13,5,1,12
104436,1063540345,123369.0,199.0,42,16,14,28
104437,1063540207,21428.0,9.0,2,0,1,1
104438,1063540338,26271.0,123.0,11,7,7,4
104440,1063540331,32226.0,107.0,27,22,9,18
104441,1063540203,23924.0,27.0,36,31,2,34
104442,1063540323,13728.0,68.0,34,20,2,32
104443,1063544576,3531.0,17.0,35,25,1,34
104445,1063540199,26681.0,50.0,71,45,4,67
104446,1063544570,55563.0,48.0,62,43,5,57
104448,1063544559,18330.0,178.0,52,28,4,48
104449,1063540191,48469.0,164.0,80,42,6,74
104452,1063551571,76905.0,186.0,27,18,6,21
104453,1063540320,10594.0,49.0,63,19,4,59
104454,1063540318,209.0,17.0,37,15,1,36
104455,1063540317,15661.0,33.0,40,17,3,37
104458,1063540641,16384.0,89.0,87,49,2,85
104461,1063540311,13215.0,47.0,26,19,3,23
104462,1063540455,42723.0,45.0,42,32,3,39
104463,1063540645,32674.0,5.0,72,48,2,70
104464,1063540452,5063.0,38.0,23,15,4,19
104466,1063540437,21500.0,125.0,12,6,7,5
104468,1063540423,41786.0,214.0,33,26,5,28
104469,1063540416,11402.0,96.0,18,13,3,15
104490,1063540402,15996.0,104.0,19,13,5,14
104497,1063540396,4629.0,11.0,117,43,1,116
104512,1063540890,30939.0,128.0,19,9,5,14
104515,1063540881,85037.0,74.0,38,15,3,35
104516,1063540868,79173.0,181.0,108,60,20,88
104518,1063540864,94136.0,214.0,63,24,9,54
104519,1063540657,11883.0,152.0,37,11,4,33
104576,1063541446,4129.0,4.0,22,4,2,20
104580,1063541438,159.0,268.0,52,14,1,51
104581,1063541430,13094.0,34.0,79,9,2,77
104629,1063541292,624.0,6.0,4,2,1,3
104636,1063541006,0.0,0.0,1,0,0,1
104665,1063540570,29924.0,79.0,85,47,7,78
104694,1063540532,0.0,0.0,4,1,0,4
104698,1063540705,22276.0,64.0,51,28,4,47
104699,1063540703,12884.0,50.0,52,35,2,50
104701,1063540698,8675.0,14.0,9,4,2,7
104713,1063542205,7037.0,82.0,16,9,2,14
104723,1063540737,19335.0,21.0,8,3,4,4
104726,1063542196,4446.0,40.0,24,14,2,22
104748,1063542179,14247.0,164.0,34,12,5,29
104761,1063540668,965.0,6.0,14,2,1,13
104803,1063540690,7166.0,12.0,5,1,1,4
104817,1063540670,3595.0,158.0,39,8,3,36
104829,1063541284,0.0,85.0,16,12,0,16
104842,1063540810,33585.0,144.0,60,37,6,54
104851,1063540559,48148.0,156.0,60,34,16,44
104852,1063540808,5200.0,10.0,34,12,1,33
104856,1063540797,5137.0,23.0,31,13,2,29
104882,1063540638,57432.0,83.0,88,28,5,83
104886,1063540635,0.0,0.0,1,0,0,1
104888,1063540632,22583.0,68.0,51,31,4,47
104892,1063540621,0.0,1.0,36,30,0,36
104897,1063540615,53055.0,173.0,53,29,3,50
104902,1063540759,26550.0,37.0,81,18,5,76
104943,1063540472,8890.0,84.0,14,6,2,12
104945,1063542172,17834.0,12.0,23,5,1,22
104948,1063540795,3035.0,10.0,3,2,2,1
104975,1063540682,45874.0,132.0,56,23,5,51
104977,1063540674,11434.0,80.0,64,23,6,58
104981,1063540792,751.0,34.0,32,22,1,31
104991,1063541001,19377.0,146.0,31,14,5,26
104994,1063540787,0.0,3.0,6,2,0,6
104996,1063542023,3757.0,31.0,60,37,2,58
105027,1063540933,80338.0,202.0,67,45,11,56
105029,1063540922,40079.0,78.0,66,48,8,58
105030,1063540768,0.0,0.0,1,0,0,1
105032,1063540918,300358.0,192.0,48,35,11,37
105033,1063540907,99428.0,84.0,54,43,9,45
105036,1063540899,45661.0,77.0,130,105,9,121
105042,1063542026,10372.0,121.0,35,20,4,31
105064,1063540830,172019.0,187.0,26,22,5,21
105074,1063540827,147411.0,44.0,19,13,3,16
105079,1063540823,31882.0,51.0,32,22,3,29
105089,1063541279,38326.0,46.0,13,3,3,10
105095,1063541268,0.0,2.0,26,18,0,26
105097,1063540613,0.0,0.0,3,1,0,3
105123,1063540894,27627.0,35.0,37,30,2,35
105131,1063541419,15434.0,41.0,31,3,4,27
105214,1063540963,44275.0,91.0,49,32,6,43
105215,1063540951,31888.0,48.0,55,35,2,53
105220,1063540948,90222.0,126.0,43,14,8,35
105230,1063541131,8009.0,32.0,22,9,4,18
105231,1063540943,32534.0,59.0,71,47,3,68
105232,1063540820,3179.0,9.0,5,0,1,4
105234,1063541098,14043.0,190.0,69,38,6,63
105235,1063541128,23899.0,314.0,53,40,6,47
105237,1063541116,12206.0,59.0,95,65,3,92
105240,1063541103,10398.0,40.0,34,25,1,33
105252,1063541236,77830.0,62.0,89,56,7,82
105266,1063541227,236368.0,162.0,37,10,7,30
105267,1063540757,82282.0,109.0,107,55,5,102
105276,1063541224,0.0,3.0,58,45,0,58
105283,1063541214,6216.0,199.0,33,21,3,30
105324,1063541407,10136.0,78.0,51,33,4,47
105325,1063541404,58185.0,130.0,95,38,7,88
105326,1063541401,1389.0,24.0,42,21,1,41
105354,1063541025,0.0,110.0,21,6,0,21
105401,1063540846,2027.0,9.0,32,26,1,31
105402,1063540839,18605.0,130.0,11,7,3,8
105429,1063541398,15764.0,31.0,11,3,2,9
105453,1063540813,0.0,0.0,1,0,0,1
105500,1063540936,21352.0,29.0,23,13,2,21
105501,1063540985,0.0,0.0,2,0,0,2
105564,1063540833,31114.0,62.0,44,28,5,39
105579,1063541093,0.0,0.0,1,0,0,1
105580,1063541087,81273.0,37.0,20,17,3,17
105581,1063541083,79304.0,18.0,12,9,2,10
105594,1063541874,30972.0,58.0,46,40,3,43
105606,1063541198,36052.0,49.0,41,18,7,34
105607,1063541191,65124.0,127.0,69,49,4,65
105608,1063541184,61560.0,110.0,54,39,5,49
105610,1063541170,302913.0,147.0,38,29,6,32
105611,1063541160,359028.0,172.0,41,24,10,31
105612,1063541156,407247.0,53.0,24,9,6,18
105614,1063541148,73426.0,177.0,84,58,4,80
105618,1063540982,1933.0,2.0,33,15,2,31
105621,1063540973,7748.0,7.0,39,25,3,36
105628,1063540967,46599.0,41.0,27,20,4,23
105666,1063541023,12535.0,106.0,27,15,3,24
105728,1063541062,6707.0,38.0,5,1,2,3
105754,1063541077,76723.0,13.0,10,4,1,9
105755,1063541060,0.0,0.0,26,0,0,26
105800,1063543614,28817.0,318.0,53,25,7,46
105804,1063543604,5339.0,71.0,31,14,2,29
105810,1063543601,45788.0,191.0,59,43,9,50
105814,1063543592,119588.0,243.0,64,55,10,54
105826,1063541315,30078.0,163.0,51,21,8,43
105872,1063541453,27789.0,33.0,19,11,6,13
105874,1063541051,317.0,20.0,35,1,3,32
105908,1063541203,18363.0,193.0,33,23,3,30
106074,1063541985,20718.0,112.0,21,13,3,18
106114,1063541629,30587.0,51.0,45,34,3,42
106143,1063541264,0.0,1.0,30,17,0,30
106145,1063541261,13320.0,59.0,358,21,1,357
106147,1063541246,15585.0,37.0,107,49,1,106
106148,1063541656,42039.0,59.0,49,30,2,47
106177,1063541530,2482.0,52.0,8,1,6,2
106179,1063541523,65225.0,175.0,47,21,5,42
106189,1063541510,52523.0,78.0,35,19,3,32
106191,1063541502,38921.0,69.0,72,22,2,70
106206,1063541913,523.0,40.0,7,2,3,4
106207,1063541910,69960.0,69.0,48,38,5,43
106239,1063541413,7171.0,73.0,15,4,4,11
106279,1063542039,0.0,256.0,22,10,0,22
106283,1063541318,16244.0,169.0,79,43,4,75
106298,1063541368,27968.0,198.0,84,61,2,82
106318,1063544604,15283.0,98.0,76,5,13,63
106325,1063544596,81898.0,164.0,31,14,12,19
106326,1063544591,70486.0,210.0,64,11,16,48
106337,1063542035,55125.0,384.0,65,35,7,58
106354,1063541627,46860.0,93.0,18,9,5,13
106362,1063541982,27367.0,55.0,7,2,3,4
106363,1063547794,1315.0,32.0,5,1,1,4
106436,1063541661,13692.0,78.0,17,6,5,12
106438,1063541309,32228.0,152.0,33,17,8,25
106439,1063541307,31624.0,175.0,21,15,7,14
106441,1063541298,166479.0,445.0,253,55,17,236
106443,1063541384,2159.0,5.0,7,3,1,6
106451,1063541349,39476.0,52.0,54,28,2,52
106456,1063541346,23562.0,20.0,5,2,1,4
106497,1063541392,8121.0,30.0,12,6,2,10
106499,1063541549,72609.0,208.0,30,16,7,23
106500,1063541545,49226.0,244.0,28,16,6,22
106508,1063541539,42247.0,62.0,63,41,4,59
106513,1063541534,10213.0,42.0,19,10,5,14
106526,1063541742,4228.0,17.0,25,18,3,22
106528,1063541731,82879.0,54.0,122,81,4,118
106530,1063541723,82423.0,131.0,144,90,10,134
106551,1063541487,3765.0,25.0,34,17,6,28
106552,1063542154,0.0,292.0,12,4,0,12
106615,1063541476,41190.0,209.0,96,27,6,90
106640,1063541971,20420.0,79.0,21,17,4,17
106654,1063541700,0.0,0.0,19,5,0,19
106655,1063541693,2738.0,32.0,34,23,2,32
106656,1063541691,5531.0,13.0,10,5,1,9
106657,1063541679,994.0,35.0,23,11,1,22
106660,1063541676,28889.0,81.0,34,10,3,31
106672,1063541716,141209.0,118.0,108,54,6,102
106673,1063545174,51340.0,112.0,51,40,9,42
106679,1063541624,0.0,0.0,3,0,0,3
106681,1063541709,24239.0,140.0,55,32,4,51
106719,1063541469,85083.0,281.0,116,47,11,105
106720,1063541463,78096.0,190.0,51,26,7,44
106728,1063542370,38367.0,76.0,51,39,6,45
106739,1063547734,65290.0,131.0,27,14,7,20
106740,1063541457,21462.0,228.0,29,8,4,25
106769,1063541565,29342.0,24.0,6,2,1,5
106770,1063541614,24842.0,23.0,13,2,3,10
106771,1063541608,51098.0,112.0,21,6,7,14
106772,1063541606,92493.0,55.0,31,11,7,24
106782,1063541456,0.0,1.0,12,8,0,12
106787,1063541531,50031.0,140.0,41,21,9,32
106827,1063541903,139105.0,9.0,9,8,1,8
106855,1063541593,109100.0,35.0,18,6,7,11
106856,1063541584,172310.0,52.0,27,7,3,24
106857,1063541570,290894.0,110.0,73,31,11,62
106868,1063541962,2818.0,17.0,11,5,1,10
106886,1063541858,30013.0,19.0,70,38,1,69
106897,1063541853,29298.0,28.0,33,14,3,30
106899,1063541846,36377.0,80.0,52,23,4,48
106906,1063542030,4660.0,244.0,26,7,3,23
106920,1063541842,30013.0,1.0,33,14,1,32
106932,1063541838,0.0,1.0,7,6,0,7
106934,1063541563,17485.0,54.0,62,46,4,58
106946,1063541830,54808.0,60.0,93,63,7,86
106948,1063541820,18885.0,64.0,51,21,3,48
106949,1063541662,19890.0,168.0,52,22,5,47
106972,1063541813,2190.0,46.0,65,42,1,64
106973,1063541850,36014.0,107.0,18,7,9,9
106974,1063541806,18908.0,24.0,16,9,1,15
106981,1063541840,87076.0,45.0,22,10,8,14
106985,1063541802,31563.0,53.0,48,30,2,46
107021,1063541673,41380.0,101.0,27,9,4,23
107022,1063541617,15008.0,216.0,90,56,3,87
107032,1063547749,8401.0,62.0,16,3,4,12
107033,1063541831,77215.0,58.0,24,16,4,20
107034,1063547752,59169.0,101.0,45,18,10,35
107082,1063541836,30013.0,1.0,27,13,1,26
107088,1063541944,15442.0,37.0,7,3,3,4
107091,1063542151,2205.0,33.0,12,9,2,10
107106,1063541799,61065.0,315.0,86,46,11,75
107109,1063541790,55691.0,264.0,35,25,7,28
107117,1063541777,45073.0,45.0,788,32,3,785
107125,1063541763,32727.0,20.0,16,11,1,15
107155,1063542008,48762.0,39.0,8,3,3,5
107157,1063542007,4607.0,40.0,20,9,3,17
107159,1063542003,66227.0,250.0,46,35,8,38
107160,1063542671,21930.0,19.0,26,15,2,24
107161,1063547501,4904.0,28.0,24,17,2,22
107163,1063541744,11595.0,156.0,19,12,2,17
107164,1063541743,955.0,1.0,2,0,1,1
107166,1063541884,68348.0,34.0,58,19,4,54
107220,1063542002,14054.0,51.0,15,5,4,11
107223,1063542000,9779.0,25.0,10,7,1,9
107224,1063541671,0.0,14.0,23,7,0,23
107276,1063541758,35685.0,61.0,24,23,3,21
107277,1063541666,0.0,0.0,2,1,0,2
107408,1063541868,0.0,0.0,1,0,0,1
107409,1063541866,0.0,6.0,5,0,0,5
107429,1063541865,18919.0,79.0,53,25,5,48
107440,1063541896,69740.0,104.0,44,28,5,39
107486,1063541881,400.0,3.0,9,3,1,8
107574,1063541939,12341.0,38.0,32,17,4,28
107625,1063542146,9732.0,58.0,53,34,3,50
107666,1063542012,19325.0,46.0,16,7,3,13
107681,1063542329,11161.0,81.0,86,55,7,79
107683,1063542324,15535.0,45.0,68,39,5,63
107684,1063542317,7199.0,16.0,22,11,3,19
107769,1063541957,11959.0,120.0,14,7,5,9
107780,1063541936,1850.0,12.0,7,4,1,6
107811,1063541927,1900.0,9.0,13,2,1,12
107813,1063542104,5826.0,36.0,26,20,3,23
107821,1063542142,3156.0,39.0,20,4,4,16
107831,1063542308,0.0,4.0,9,0,0,9
107834,1063542357,0.0,13.0,26,2,0,26
107837,1063542302,0.0,0.0,1,0,0,1
107838,1063542292,14897.0,46.0,24,10,2,22
107875,1063542590,21549.0,37.0,74,57,4,70
107897,1063542353,5213.0,312.0,33,9,4,29
107898,1063542252,53657.0,69.0,49,36,6,43
107911,1063542275,10187.0,46.0,35,28,3,32
107917,1063542247,41525.0,49.0,25,17,6,19
107920,1063542244,69445.0,50.0,25,16,8,17
107921,1063542238,44567.0,71.0,21,14,5,16
107928,1063542221,19295.0,22.0,11,5,4,7
107929,1063542211,6583.0,7.0,6,3,1,5
107930,1063542273,9372.0,59.0,42,32,3,39
107935,1063542270,4655.0,88.0,26,16,3,23
107936,1063542262,17593.0,72.0,47,18,4,43
107939,1063542081,29235.0,26.0,30,19,4,26
107940,1063542258,2086.0,1.0,8,5,1,7
107941,1063542066,10406.0,70.0,37,9,3,34
107943,1063542064,33011.0,138.0,92,24,7,85
107944,1063542057,121562.0,149.0,117,55,6,111
107945,1063542361,11201.0,145.0,24,6,1,23
107947,1063542055,31993.0,153.0,112,67,5,107
107956,1063542052,1577.0,26.0,92,71,2,90
107960,1063542098,38618.0,16.0,13,8,4,9
107975,1063547774,93391.0,134.0,58,42,7,51
107977,1063542350,17096.0,143.0,28,14,6,22
107979,1063542093,10819.0,87.0,106,6,9,97
107984,1063542134,17616.0,62.0,35,30,4,31
107986,1063542610,246117.0,355.0,96,44,14,82
107989,1063542315,0.0,1.0,22,15,0,22
107993,1063542310,13588.0,164.0,8,6,3,5
107994,1063543099,468093.0,172.0,47,32,11,36
107997,1063542604,0.0,1.0,5,3,0,5
107998,1063544314,65396.0,224.0,68,38,5,63
108001,1063542041,69599.0,63.0,148,64,5,143
108005,1063542344,21753.0,71.0,57,45,5,52
108006,1063542337,66756.0,113.0,27,20,7,20
108008,1063542333,119225.0,272.0,85,63,15,70
108025,1063542121,7712.0,6.0,13,11,1,12
108028,1063542289,12684.0,43.0,8,2,4,4
108032,1063542281,4435.0,57.0,10,5,3,7
108040,1063542107,10598.0,193.0,49,25,6,43
108152,1063542791,8567.0,48.0,7,1,1,6
108167,1063542784,384931.0,606.0,66,31,23,43
108176,1063542331,2599.0,10.0,23,16,2,21
108177,1063542390,29048.0,152.0,189,73,7,182
108178,1063542379,42939.0,164.0,18,2,10,8
108179,1063542376,21693.0,126.0,24,5,3,21
108307,1063542412,2485.0,11.0,6,0,2,4
108308,1063542409,62212.0,146.0,45,16,13,32
108309,1063542400,21107.0,40.0,12,4,4,8
108310,1063542393,43918.0,133.0,42,19,9,33
108311,1063542392,11878.0,46.0,36,14,5,31
108439,1063542573,58279.0,19.0,21,11,1,20
108445,1063542567,0.0,0.0,2,0,0,2
108448,1063542560,26643.0,118.0,97,28,5,92
108450,1063542554,6535.0,73.0,1084,26,1,1083
108457,1063542547,4354.0,27.0,28,14,1,27
108471,1063542545,0.0,3.0,41,22,0,41
108478,1063542537,68157.0,123.0,54,36,6,48
108479,1063542531,24393.0,21.0,95,56,2,93
108480,1063542471,20636.0,30.0,9,6,4,5
108494,1063542520,44498.0,137.0,39,19,16,23
108495,1063542465,15803.0,74.0,72,8,4,68
108499,1063542518,101514.0,184.0,89,38,6,83
108501,1063542512,43339.0,90.0,87,55,6,81
108505,1063542506,35576.0,75.0,28,23,6,22
108514,1063543576,74342.0,136.0,75,12,15,60
108520,1063542456,85336.0,185.0,129,81,9,120
108521,1063542453,128700.0,174.0,137,97,15,122
108636,1063543004,9754.0,175.0,41,16,2,39
108640,1063542439,9072.0,45.0,26,20,3,23
108643,1063542436,0.0,8.0,16,14,0,16
108653,1063542430,27547.0,100.0,11,8,3,8
108672,1063542489,84356.0,108.0,43,28,7,36
108674,1063542423,22182.0,25.0,94,32,2,92
108682,1063542667,11061.0,27.0,90,63,5,85
108684,1063542664,68318.0,294.0,110,75,17,93
108686,1063542650,6083.0,19.0,36,19,3,33
108687,1063542644,21176.0,215.0,92,68,8,84
108689,1063542639,40123.0,101.0,46,37,6,40
108690,1063542636,14424.0,17.0,94,83,4,90
108693,1063542625,6400.0,12.0,31,22,2,29
108696,1063542621,6819.0,24.0,34,9,1,33
108697,1063542598,2512.0,34.0,61,13,1,60
108698,1063542593,10398.0,11.0,6,4,1,5
108705,1063542444,36331.0,60.0,47,43,4,43
108706,1063542775,70045.0,328.0,45,22,12,33
108748,1063542477,31518.0,24.0,58,24,2,56
108753,1063542420,5730.0,13.0,14,12,1,13
108778,1063542714,13602.0,99.0,18,5,6,12
108786,1063542711,3906.0,38.0,71,8,2,69
108787,1063542704,592.0,1.0,13,1,1,12
108810,1063542737,43907.0,438.0,77,41,8,69
108828,1063542994,17387.0,239.0,339,22,2,337
108847,1063542614,1386.0,10.0,8,5,1,7
108874,1063542701,6179.0,16.0,11,5,3,8
108875,1063542690,0.0,0.0,24,9,0,24
108876,1063542683,0.0,0.0,13,9,0,13
108877,1063542676,1754.0,27.0,12,6,2,10
108895,1063542673,15508.0,48.0,3,2,2,1
108918,1063542582,13037.0,68.0,18,14,2,16
108920,1063547511,61697.0,394.0,55,29,18,37
108937,1063542992,76678.0,120.0,15,6,8,7
108945,1063542725,1253.0,16.0,4,3,1,3
108975,1063542574,12062.0,42.0,10,1,2,8
109012,1063547753,19006.0,81.0,30,20,1,29
109019,1063547739,241423.0,522.0,189,64,20,169
109061,1063542846,0.0,0.0,5,4,0,5
109112,1063542844,2037.0,212.0,14,5,1,13
109192,1063542829,145359.0,161.0,38,26,9,29
109193,1063542823,244277.0,126.0,30,13,8,22
109195,1063542820,146908.0,110.0,43,20,8,35
109196,1063542814,22151.0,144.0,23,6,8,15
109197,1063542717,12431.0,24.0,24,13,4,20
109209,1063542734,7327.0,39.0,18,13,2,16
109210,1063542756,0.0,0.0,6,3,0,6
109228,1063542889,4832.0,9.0,25,5,1,24
109238,1063542882,9059.0,4.0,19,7,1,18
109240,1063542873,4994.0,2.0,9,3,1,8
109244,1063542871,0.0,0.0,7,1,0,7
109259,1063542813,24628.0,89.0,15,5,6,9
109260,1063542861,66977.0,113.0,62,29,7,55
109304,1063542988,19024.0,21.0,11,3,1,10
109319,1063542721,21591.0,98.0,32,11,4,28
109321,1063542751,43020.0,34.0,21,14,4,17
109341,1063542800,0.0,0.0,2,0,0,2
109415,1063543219,12679.0,75.0,12,2,2,10
109423,1063542927,1506.0,70.0,6,4,1,5
109456,1063542971,0.0,5.0,25,18,0,25
109458,1063542966,47664.0,205.0,40,19,5,35
109460,1063542955,75194.0,52.0,68,30,4,64
109463,1063542936,2200.0,52.0,11,7,1,10
109465,1063542952,106732.0,269.0,45,23,7,38
109477,1063542948,90183.0,45.0,37,15,5,32
109479,1063542946,106739.0,156.0,79,31,5,74
109497,1063542758,95652.0,296.0,64,23,8,56
109506,1063542940,29956.0,132.0,45,27,6,39
109532,1063543126,36117.0,147.0,127,105,5,122
109540,1063543124,35171.0,99.0,118,73,3,115
109544,1063543117,21502.0,56.0,31,11,5,26
109546,1063543109,10432.0,89.0,77,45,6,71
109547,1063543114,96850.0,75.0,12,6,2,10
109563,1063543056,2830.0,4.0,3,0,1,2
109565,1063543045,72014.0,36.0,25,13,8,17
109566,1063543040,112128.0,127.0,37,10,7,30
109588,1063542865,4439.0,6.0,22,12,1,21
109632,1063543111,41663.0,121.0,75,38,9,66
109634,1063543104,2831.0,33.0,11,4,2,9
109651,1063543094,76406.0,131.0,48,33,5,43
109661,1063543081,59000.0,129.0,68,50,7,61
109663,1063543079,255.0,28.0,27,9,1,26
109666,1063543071,4656.0,3.0,10,5,1,9
109667,1063542895,45584.0,124.0,55,31,7,48
109678,1063542851,1843.0,9.0,8,0,1,7
109707,1063542980,0.0,0.0,3,2,0,3
109751,1063543224,12433.0,26.0,37,16,3,34
109754,1063543200,3870.0,0.0,18,9,1,17
109757,1063543197,123323.0,57.0,22,14,5,17
109760,1063543184,27055.0,84.0,24,17,3,21
109762,1063543512,39885.0,99.0,34,17,10,24
109765,1063543170,57730.0,86.0,23,18,5,18
109771,1063543159,17227.0,26.0,32,25,3,29
109795,1063542891,5214.0,22.0,39,19,2,37
109799,1063544094,2201.0,8.0,23,18,1,22
109801,1063544083,18804.0,197.0,51,19,5,46
109807,1063544076,10141.0,58.0,25,18,3,22
109809,1063544064,10419.0,132.0,38,14,3,35
109956,1063543299,4117.0,57.0,23,13,3,20
109959,1063543293,47830.0,147.0,69,31,10,59
109969,1063543291,70406.0,58.0,27,10,4,23
109981,1063543290,0.0,0.0,4,2,0,4
109983,1063543284,34953.0,120.0,13,10,6,7
109997,1063543068,23898.0,28.0,13,5,3,10
109998,1063543063,99720.0,251.0,26,9,5,21
110055,1063543642,8139.0,34.0,13,7,2,11
110061,1063543147,9561.0,84.0,33,12,2,31
110068,1063543145,29583.0,75.0,49,11,5,44
110084,1063543037,47163.0,221.0,30,11,9,21
110085,1063543025,75304.0,246.0,320,29,10,310
110100,1063543134,1674.0,15.0,13,6,1,12
110101,1063543327,57436.0,166.0,144,39,12,132
110109,1063543331,14665.0,178.0,24,11,3,21
110111,1063543332,43757.0,138.0,66,32,8,58
110136,1063543016,7429.0,55.0,32,26,3,29
110148,1063543216,21278.0,193.0,73,49,3,70
110205,1063543325,51766.0,182.0,54,28,10,44
110213,1063543322,23546.0,81.0,8,2,6,2
110244,1063543315,15065.0,43.0,13,4,4,9
110249,1063543230,22000.0,44.0,59,41,2,57
110278,1063543723,68204.0,248.0,41,29,8,33
110298,1063543710,29065.0,123.0,54,31,8,46
110299,1063543704,43222.0,94.0,87,61,5,82
110300,1063543700,23717.0,6.0,15,10,1,14
110301,1063543671,40967.0,52.0,30,18,3,27
110332,1063543310,6533.0,19.0,17,10,3,14
110333,1063543265,45819.0,104.0,36,4,3,33
110337,1063543252,1113.0,11.0,17,8,1,16
110339,1063543235,0.0,0.0,14,1,0,14
110357,1063543351,22091.0,17.0,13,8,3,10
110358,1063543338,25985.0,5.0,46,34,4,42
110387,1063543277,46063.0,214.0,45,28,7,38
110397,1063543426,201398.0,66.0,25,18,5,20
110419,1063543422,1996.0,22.0,27,16,2,25
110432,1063543415,41586.0,29.0,12,7,3,9
110435,1063543413,423.0,22.0,10,4,1,9
110437,1063543405,23480.0,237.0,25,3,11,14
110439,1063543396,5786.0,17.0,222,4,1,221
110440,1063543395,7891.0,13.0,11,3,4,7
110443,1063543391,69788.0,115.0,38,31,1,37
110444,1063543386,118193.0,121.0,34,13,4,30
110445,1063543384,21178.0,71.0,26,18,2,24
110446,1063543381,107688.0,50.0,31,18,2,29
110450,1063543266,10753.0,47.0,13,3,3,10
110461,1063543301,12267.0,65.0,4,2,3,1
110464,1063543506,12284.0,46.0,70,45,2,68
110478,1063543573,26356.0,64.0,18,9,4,14
110486,1063543638,56959.0,57.0,39,14,4,35
110507,1063543269,120570.0,70.0,30,15,4,26
110524,1063545560,83548.0,154.0,75,52,8,67
110531,1063543374,9649.0,14.0,32,3,1,31
110555,1063543362,37223.0,210.0,49,16,16,33
110556,1063543354,11156.0,61.0,31,23,2,29
110560,1063543862,21152.0,85.0,108,82,2,106
110565,1063543599,38637.0,228.0,27,19,6,21
110572,1063543372,60844.0,104.0,25,5,6,19
110573,1063543368,37245.0,100.0,80,46,6,74
110583,1063545469,36253.0,153.0,61,40,6,55
110596,1063543563,0.0,0.0,15,7,0,15
110599,1063543560,41044.0,40.0,323,33,3,320
110604,1063543545,0.0,0.0,11,8,0,11
110605,1063543493,30048.0,140.0,40,27,5,35
110606,1063543489,29495.0,59.0,15,9,3,12
110609,1063543482,0.0,0.0,20,8,0,20
110610,1063543541,4472.0,6.0,40,32,2,38
110612,1063543531,144.0,175.0,96,53,2,94
110615,1063543999,22011.0,15.0,4,3,2,2
110619,1063543991,24379.0,95.0,6,4,4,2
110622,1063543479,0.0,0.0,1,0,0,1
110631,1063543986,66403.0,41.0,10,6,4,6
110639,1063543474,24649.0,96.0,26,15,3,23
110649,1063543669,2714.0,8.0,9,8,1,8
110650,1063543667,30293.0,101.0,58,41,5,53
110651,1063543660,18767.0,19.0,13,7,2,11
110674,1063547676,15369.0,126.0,34,20,5,29
110675,1063543464,3168.0,33.0,50,38,2,48
110677,1063543455,68341.0,94.0,72,24,11,61
110678,1063543379,67282.0,402.0,101,46,7,94
110680,1063543451,19136.0,18.0,59,30,3,56
110684,1063543441,27423.0,300.0,50,23,5,45
110706,1063543503,68949.0,40.0,12,5,6,6
110747,1063543522,39001.0,191.0,74,56,7,67
110786,1063543634,31412.0,101.0,83,27,5,78
110787,1063543622,6543.0,75.0,36,16,2,34
110796,1063543436,1839.0,38.0,17,7,2,15
110801,1063543432,5957.0,24.0,8,4,5,3
110803,1063543438,87505.0,150.0,79,22,7,72
110807,1063543852,21532.0,18.0,15,4,5,10
110808,1063543843,1406.0,18.0,8,6,1,7
110833,1063543826,70915.0,218.0,56,27,8,48
110859,1063543930,53201.0,173.0,52,15,12,40
110860,1063543926,2152.0,54.0,25,17,2,23
110863,1063543917,122347.0,131.0,31,20,8,23
110864,1063543914,35611.0,162.0,50,19,11,39
110865,1063543907,36043.0,184.0,58,23,15,43
110913,1063544060,43802.0,17.0,7,2,2,5
110916,1063544204,6294.0,13.0,23,9,2,21
110917,1063544200,20328.0,66.0,32,13,6,26
110936,1063544192,51605.0,254.0,61,26,10,51
110944,1063547499,6337.0,16.0,12,4,6,6
110949,1063543858,9807.0,72.0,28,20,3,25
110950,1063543589,51156.0,75.0,14,4,5,9
110977,1063543619,19418.0,161.0,83,40,5,78
110993,1063543583,34251.0,95.0,8,2,5,3
110995,1063543579,3514.0,9.0,3,0,1,2
111001,1063544062,67645.0,354.0,98,58,8,90
111007,1063543803,0.0,0.0,1,0,0,1
111057,1063543778,1320.0,9.0,3,2,1,2
111058,1063543774,54856.0,12.0,12,7,3,9
111070,1063543771,65445.0,123.0,13,7,6,7
111073,1063543762,19200.0,56.0,14,9,4,10
111075,1063543757,26985.0,143.0,54,32,6,48
111119,1063543755,71314.0,79.0,39,31,4,35
111133,1063543736,36288.0,26.0,29,9,2,27
111157,1063543797,17304.0,206.0,59,32,4,55
111159,1063543792,4069.0,174.0,16,3,5,11
111162,1063544185,39798.0,125.0,48,26,5,43
111165,1063543786,1058.0,5.0,7,4,1,6
111196,1063544116,15199.0,100.0,53,15,15,38
111205,1063543936,1211.0,26.0,42,36,2,40
111206,1063543934,3650.0,13.0,71,56,2,69
111209,1063543819,15471.0,25.0,8,6,3,5
111211,1063543811,0.0,0.0,6,2,0,6
111263,1063543647,6579.0,170.0,41,23,2,39
111269,1063543901,39424.0,258.0,112,48,7,105
111272,1063543869,20274.0,64.0,34,26,4,30
111273,1063543895,2745.0,38.0,74,32,2,72
111276,1063543931,4366.0,11.0,2,1,1,1
111285,1063543782,1058.0,1.0,6,3,1,5
111287,1063544182,596.0,15.0,27,15,1,26
111289,1063544108,30356.0,53.0,11,4,4,7
111291,1063543891,13962.0,124.0,19,10,2,17
111321,1063544467,80448.0,126.0,53,25,13,40
111333,1063543980,65142.0,3.0,8,1,2,6
111335,1063543975,62800.0,132.0,35,22,10,25
111365,1063543966,13956.0,60.0,116,77,3,113
111366,1063543959,28481.0,83.0,71,49,5,66
111368,1063543952,24766.0,66.0,80,58,4,76
111371,1063543948,49018.0,256.0,69,49,9,60
111373,1063544253,28538.0,176.0,24,18,7,17
111374,1063544252,0.0,0.0,1,0,0,1
111375,1063543889,0.0,21.0,41,25,0,41
111378,1063543872,2938.0,70.0,9,6,1,8
111396,1063543945,52741.0,38.0,19,12,1,18
111449,1063545270,28216.0,109.0,60,44,9,51
111525,1063544460,6885.0,49.0,28,14,3,25
111544,1063544027,68707.0,81.0,73,25,7,66
111546,1063544024,15396.0,66.0,61,33,1,60
111547,1063544016,4732.0,10.0,44,26,1,43
111598,1063544008,7922.0,80.0,37,28,4,33
111601,1063544002,17167.0,85.0,66,19,6,60
111615,1063544173,50139.0,73.0,117,84,6,111
111616,1063544166,117393.0,116.0,109,71,8,101
111617,1063544162,4080.0,3.0,52,46,1,51
111620,1063544456,24037.0,48.0,17,13,6,11
111622,1063544160,224216.0,51.0,79,56,6,73
111623,1063544153,927.0,25.0,46,34,1,45
111625,1063544149,6601.0,32.0,28,19,2,26
111633,1063544144,21192.0,59.0,43,25,5,38
111635,1063544140,0.0,0.0,4,3,0,4
111638,1063544137,3358.0,28.0,20,13,3,17
111640,1063544134,2461.0,29.0,45,5,2,43
111642,1063544124,3012.0,67.0,27,9,6,21
111688,1063544039,26384.0,32.0,21,13,2,19
111708,1063544206,5208.0,62.0,10,8,4,6
111715,1063544049,13180.0,85.0,9,1,3,6
111725,1063544311,45575.0,126.0,25,4,3,22
111728,1063544031,44396.0,13.0,7,4,2,5
111734,1063544249,81203.0,118.0,30,17,5,25
111748,1063544058,77104.0,263.0,69,47,9,60
111749,1063544054,97441.0,34.0,40,22,3,37
111754,1063544218,26174.0,124.0,80,35,6,74
111828,1063544302,22283.0,210.0,65,27,5,60
111830,1063544291,1462.0,19.0,25,8,2,23
111835,1063544286,59523.0,63.0,93,51,3,90
111843,1063544279,101322.0,93.0,43,31,5,38
111844,1063544275,17457.0,29.0,9,5,4,5
111846,1063544271,995.0,10.0,22,19,1,21
111949,1063544444,55775.0,49.0,34,23,5,29
111951,1063544441,16631.0,112.0,87,44,3,84
111953,1063544439,0.0,11.0,14,12,0,14
111956,1063544436,49249.0,147.0,26,23,4,22
111957,1063544428,41888.0,138.0,48,36,3,45
111989,1063544262,27937.0,48.0,20,15,2,18
111992,1063544258,29318.0,64.0,35,28,6,29
112027,1063544361,44699.0,60.0,68,53,5,63
112032,1063544346,44017.0,113.0,287,32,24,263
112033,1063544213,9110.0,26.0,18,8,5,13
112069,1063544098,18226.0,43.0,16,7,2,14
112135,1063545000,14459.0,60.0,25,20,2,23
112152,1063544404,38974.0,50.0,11,4,3,8
112154,1063544397,68933.0,235.0,36,18,6,30
112156,1063544388,30323.0,75.0,31,9,3,28
112159,1063544383,20012.0,58.0,80,37,2,78
112188,1063544233,26378.0,39.0,56,6,3,53
112192,1063544231,73094.0,112.0,46,13,3,43
112269,1063545056,13847.0,10.0,9,6,3,6
112272,1063545053,55337.0,142.0,45,17,5,40
112275,1063545052,21408.0,28.0,20,15,3,17
112335,1063544516,69712.0,103.0,34,24,5,29
112340,1063544514,93967.0,126.0,58,27,7,51
112341,1063544482,139110.0,187.0,54,30,17,37
112352,1063544407,8140.0,11.0,8,4,1,7
112354,1063544452,10380.0,325.0,54,16,7,47
112359,1063544477,10918.0,53.0,28,16,3,25
112361,1063544474,13703.0,72.0,56,23,4,52
112367,1063544320,22295.0,23.0,3,1,2,1
112384,1063544581,6168.0,67.0,23,12,5,18
112426,1063545049,14559.0,37.0,7,2,5,2
112429,1063544523,2557.0,9.0,22,8,1,21
112437,1063544556,855.0,4.0,5,2,1,4
112443,1063544552,4281.0,61.0,48,23,5,43
112444,1063544612,0.0,0.0,33,3,0,33
112470,1063544578,30622.0,58.0,52,39,6,46
112473,1063544912,37357.0,260.0,77,48,5,72
112533,1063545553,2044.0,36.0,9,7,1,8
112566,1063544878,274585.0,105.0,86,32,12,74
112570,1063544708,42737.0,144.0,28,17,6,22
112572,1063544701,48037.0,339.0,35,27,8,27
112575,1063544690,38407.0,178.0,50,35,6,44
112577,1063544683,24400.0,114.0,44,14,6,38
112586,1063544676,2563.0,5.0,14,7,1,13
112599,1063544650,65795.0,68.0,25,10,4,21
112601,1063544648,23349.0,111.0,21,9,4,17
112602,1063544639,2993.0,7.0,4,2,1,3
112604,1063544632,1894.0,51.0,21,17,2,19
112606,1063544631,41246.0,281.0,40,24,4,36
112609,1063544609,0.0,0.0,4,2,0,4
112612,1063544607,7913.0,17.0,11,9,1,10
112642,1063544661,46225.0,77.0,21,13,4,17
112762,1063544744,22931.0,63.0,33,24,3,30
112768,1063544735,16735.0,61.0,19,13,2,17
112770,1063544727,12456.0,73.0,25,14,3,22
112771,1063544719,12642.0,67.0,42,26,3,39
112772,1063544717,12043.0,73.0,12,5,4,8
112774,1063544713,64920.0,35.0,76,56,4,72
112790,1063544876,247151.0,92.0,30,16,8,22
112794,1063544870,250859.0,109.0,59,26,11,48
112795,1063544868,245519.0,170.0,78,40,11,67
112796,1063544861,364700.0,315.0,83,34,23,60
112816,1063544747,1359.0,60.0,69,46,4,65
112818,1063544772,65355.0,93.0,20,16,5,15
112822,1063544811,21395.0,150.0,49,9,4,45
112823,1063544807,123966.0,242.0,114,34,15,99
112831,1063544796,23503.0,42.0,54,15,2,52
112832,1063544786,101055.0,149.0,71,14,4,67
112833,1063544784,88100.0,201.0,107,33,11,96
112834,1063544780,40478.0,123.0,40,2,26,14
112929,1063544627,0.0,3.0,13,10,0,13
112951,1063544937,101672.0,42.0,31,16,8,23
112953,1063544932,81893.0,139.0,76,43,14,62
112960,1063544856,48808.0,239.0,125,97,7,118
112961,1063544850,37572.0,191.0,86,68,4,82
112963,1063544832,6567.0,45.0,35,22,2,33
112964,1063544827,21012.0,184.0,114,86,6,108
112966,1063544819,9416.0,35.0,20,14,4,16
112987,1063546889,7409.0,151.0,20,8,6,14
112988,1063546877,9440.0,88.0,46,12,3,43
113065,1063544906,3009.0,27.0,14,6,1,13
113068,1063544904,48530.0,30.0,12,7,2,10
113072,1063544901,41276.0,155.0,53,28,3,50
113075,1063544889,0.0,3.0,5,0,0,5
113085,1063544767,84909.0,115.0,72,44,6,66
113108,1063544746,15449.0,32.0,4,0,2,2
113118,1063544970,44534.0,56.0,38,26,5,33
113121,1063544965,81275.0,221.0,70,25,9,61
113126,1063545635,24058.0,174.0,68,40,2,66
113135,1063544995,126104.0,46.0,22,10,6,16
113168,1063546064,54811.0,88.0,59,41,4,55
113221,1063546049,45923.0,55.0,35,25,5,30
113275,1063544985,76383.0,50.0,19,14,7,12
113277,1063544981,93024.0,18.0,20,16,2,18
113284,1063544980,40673.0,70.0,61,24,5,56
113288,1063544976,90957.0,18.0,19,11,2,17
113289,1063544972,111462.0,23.0,20,13,2,18
113324,1063544925,0.0,46.0,8,4,0,8
113339,1063544923,6915.0,10.0,19,8,2,17
113355,1063544960,7284.0,16.0,11,6,2,9
113360,1063544955,14047.0,33.0,20,9,3,17
113374,1063544879,14803.0,87.0,10,5,2,8
113378,1063545336,0.0,0.0,4,0,0,4
113398,1063544941,1266.0,28.0,17,11,2,15
113400,1063546045,119196.0,188.0,102,63,16,86
113402,1063545068,13472.0,48.0,15,7,6,9
113408,1063545041,0.0,4.0,28,15,0,28
113409,1063545037,3266.0,5.0,24,14,1,23
113410,1063545031,1183.0,122.0,22,9,1,21
113411,1063545028,10871.0,25.0,32,21,1,31
113413,1063545023,48982.0,39.0,11,6,2,9
113414,1063545014,100500.0,28.0,32,23,1,31
113415,1063545012,1093.0,6.0,8,6,1,7
113417,1063545008,28812.0,19.0,5,2,2,3
113430,1063544921,224.0,35.0,8,1,1,7
113452,1063545005,0.0,0.0,3,2,0,3
113515,1063545046,2290.0,36.0,4,2,2,2
113551,1063545151,20883.0,63.0,38,27,4,34
113553,1063545137,0.0,0.0,2,1,0,2
113554,1063545142,848.0,5.0,12,9,1,11
113555,1063545133,107072.0,179.0,45,38,8,37
113557,1063545154,1212.0,5.0,2,1,1,1
113595,1063545092,15263.0,81.0,16,6,2,14
113597,1063545072,10219.0,209.0,26,17,4,22
113650,1063545287,503.0,25.0,5,1,2,3
113652,1063545284,58814.0,96.0,78,55,5,73
113668,1063545004,44211.0,63.0,68,30,5,63
113688,1063545551,0.0,3.0,31,4,0,31
113695,1063545768,120315.0,460.0,68,14,18,50
113701,1063545280,31725.0,95.0,39,31,8,31
113712,1063545761,4080.0,76.0,23,16,1,22
113714,1063545754,39837.0,150.0,19,3,5,14
113717,1063545743,43032.0,50.0,60,12,5,55
113722,1063545741,29937.0,93.0,13,1,2,11
113724,1063545740,0.0,0.0,4,1,0,4
113728,1063545736,54729.0,62.0,23,8,2,21
113733,1063545279,6333.0,23.0,15,11,2,13
113741,1063545331,11126.0,1.0,4,2,1,3
113758,1063545100,14160.0,17.0,19,9,4,15
113760,1063545622,81660.0,142.0,37,22,7,30
113781,1063545163,56123.0,135.0,76,50,7,69
113782,1063545070,34931.0,98.0,58,23,5,53
113785,1063545230,82530.0,30.0,28,15,3,25
113799,1063545228,82649.0,95.0,50,26,7,43
113800,1063545227,152867.0,153.0,34,24,11,23
113803,1063545129,17176.0,166.0,6,4,3,3
113807,1063545122,638.0,14.0,3,1,1,2
113810,1063545734,9986.0,43.0,24,4,2,22
113811,1063545120,1856.0,18.0,5,2,1,4
113814,1063545117,132479.0,220.0,33,15,7,26
113818,1063545105,85445.0,154.0,17,6,6,11
113823,1063545110,127569.0,334.0,36,15,9,27
113824,1063545365,0.0,0.0,9,7,0,9
113896,1063545083,2808.0,2.0,2,0,1,1
113897,1063545262,5981.0,56.0,8,4,3,5
113903,1063545461,32952.0,50.0,34,18,7,27
113914,1063545617,0.0,201.0,54,41,0,54
113919,1063545086,6342.0,7.0,17,11,1,16
113945,1063545160,14598.0,34.0,5,1,4,1
113946,1063545457,41522.0,68.0,11,5,6,5
113947,1063545178,125739.0,90.0,29,12,11,18
113950,1063546041,37343.0,16.0,36,25,2,34
113957,1063545259,68549.0,494.0,99,31,32,67
113958,1063545252,101732.0,358.0,75,17,13,62
113960,1063545246,18297.0,38.0,21,15,4,17
113962,1063545238,1355.0,11.0,9,4,1,8
113975,1063545234,38663.0,96.0,30,18,7,23
113976,1063545198,6406.0,13.0,53,26,1,52
113982,1063545194,2604.0,14.0,45,36,2,43
113984,1063545275,109348.0,296.0,73,52,9,64
114048,1063545547,7297.0,203.0,69,34,5,64
114051,1063545216,247094.0,106.0,50,25,7,43
114056,1063545210,197893.0,298.0,53,27,12,41
114072,1063545191,4294.0,110.0,32,19,4,28
114076,1063545327,22312.0,81.0,10,7,6,4
114079,1063545453,17965.0,60.0,5,2,4,1
114080,1063545313,190941.0,310.0,73,33,15,58
114081,1063545306,65999.0,98.0,24,18,9,15
114082,1063545185,15893.0,43.0,31,17,3,28
114083,1063545181,26298.0,180.0,27,18,3,24
114140,1063545301,38433.0,41.0,11,6,8,3
114141,1063546843,56809.0,65.0,24,15,8,16
114142,1063545294,30226.0,177.0,65,39,7,58
114187,1063545363,3402.0,1.0,34,14,2,32
114188,1063545353,31567.0,36.0,13,9,4,9
114190,1063545346,49489.0,188.0,54,44,8,46
114203,1063545381,44697.0,39.0,34,22,6,28
114237,1063545447,17888.0,26.0,54,31,4,50
114241,1063545489,0.0,7.0,23,16,0,23
114243,1063545485,44604.0,95.0,29,15,4,25
114246,1063545483,31105.0,216.0,48,29,5,43
114252,1063545477,25688.0,92.0,61,29,3,58
114271,1063545380,7832.0,52.0,16,11,3,13
114273,1063546382,73842.0,39.0,14,6,3,11
114276,1063545370,8009.0,42.0,16,11,3,13
114277,1063546374,19045.0,8.0,23,5,3,20
114282,1063546372,75620.0,27.0,18,4,1,17
114289,1063545544,18647.0,57.0,19,11,3,16
114290,1063545536,34444.0,55.0,23,18,3,20
114325,1063545604,5362.0,31.0,44,36,3,41
114328,1063545342,0.0,0.0,13,4,0,13
114330,1063545472,31813.0,185.0,10,2,4,6
114342,1063545339,1296.0,33.0,8,6,2,6
114379,1063545444,9335.0,139.0,25,14,2,23
114402,1063545533,0.0,0.0,3,0,0,3
114412,1063545439,68292.0,39.0,55,47,4,51
114414,1063545428,12440.0,30.0,28,22,2,26
114432,1063546088,2201.0,224.0,62,21,1,61
114433,1063546084,6547.0,167.0,29,22,2,27
114435,1063545417,41915.0,148.0,68,33,4,64
114437,1063545410,43517.0,166.0,41,27,8,33
114438,1063546081,0.0,47.0,95,55,0,95
114442,1063545406,4780.0,33.0,10,2,2,8
114443,1063545404,1118.0,6.0,7,3,1,6
114444,1063545399,5563.0,300.0,106,27,3,103
114445,1063545393,10975.0,31.0,31,16,4,27
114447,1063546078,0.0,5.0,5,3,0,5
114463,1063545385,0.0,2.0,16,11,0,16
114518,1063545584,6970.0,11.0,49,13,2,47
114546,1063545577,41191.0,290.0,105,41,3,102
114561,1063545567,0.0,7.0,47,20,0,47
114562,1063545564,0.0,2.0,7,0,0,7
114563,1063545562,15605.0,49.0,32,17,1,31
114564,1063545991,0.0,3.0,32,6,0,32
114565,1063545369,63710.0,280.0,101,3,10,91
114566,1063545987,22754.0,129.0,59,19,10,49
114567,1063545978,6478.0,26.0,29,10,2,27
114568,1063545977,369.0,248.0,24,6,2,22
114575,1063545527,1282.0,1.0,2,1,1,1
114607,1063545959,28407.0,30.0,21,14,3,18
114608,1063545709,25603.0,174.0,23,6,13,10
114611,1063545703,25532.0,65.0,10,6,4,6
114612,1063545930,100824.0,55.0,39,22,8,31
114613,1063545693,5075.0,37.0,46,15,3,43
114614,1063545688,21085.0,99.0,11,7,5,6
114616,1063545938,40721.0,48.0,35,17,5,30
114619,1063545524,11993.0,69.0,5,2,2,3
114620,1063545506,31642.0,27.0,25,15,4,21
114621,1063545501,230279.0,234.0,25,12,13,12
114622,1063545498,33354.0,182.0,42,10,14,28
114623,1063545495,757.0,11.0,8,4,1,7
114624,1063545491,37294.0,71.0,22,12,5,17
114670,1063545929,5837.0,10.0,20,10,2,18
114677,1063547115,19724.0,60.0,12,2,3,9
114688,1063547106,6244.0,14.0,59,26,1,58
114738,1063545728,35589.0,35.0,16,12,3,13
114745,1063545912,1745.0,21.0,10,3,1,9
114749,1063545907,43107.0,145.0,11,6,5,6
114752,1063545897,14273.0,61.0,39,8,4,35
114753,1063545613,14940.0,103.0,46,36,2,44
114755,1063545889,84009.0,109.0,24,17,6,18
114763,1063546989,16713.0,108.0,46,35,5,41
114764,1063546984,311676.0,222.0,75,44,12,63
114794,1063546980,7101.0,28.0,72,65,2,70
114798,1063545531,0.0,0.0,1,0,0,1
114816,1063545880,30501.0,124.0,23,13,7,16
114817,1063545511,0.0,315.0,51,0,0,51
114818,1063546934,28679.0,26.0,29,22,1,28
114820,1063545873,75729.0,168.0,79,37,6,73
114822,1063546967,28059.0,88.0,88,53,3,85
114825,1063546945,40727.0,258.0,18,7,9,9
114828,1063545868,41336.0,36.0,17,12,2,15
114829,1063546478,1019.0,8.0,33,18,2,31
114830,1063545832,5019.0,50.0,9,2,3,6
114831,1063545827,8697.0,113.0,27,10,3,24
114832,1063545822,488.0,4.0,6,4,1,5
114835,1063545814,23563.0,176.0,11,5,6,5
114836,1063545808,60887.0,126.0,12,5,4,8
114855,1063545885,0.0,10.0,8,5,0,8
114857,1063545797,110084.0,101.0,52,31,5,47
114860,1063546384,14651.0,86.0,11,8,4,7
114862,1063546386,26412.0,16.0,27,11,2,25
114867,1063545676,41806.0,69.0,30,20,7,23
114893,1063546394,17172.0,6.0,25,16,1,24
114905,1063545669,0.0,0.0,24,15,0,24
114949,1063546950,4558.0,58.0,9,2,2,7
114980,1063546030,30027.0,54.0,122,70,2,120
114983,1063546401,62683.0,105.0,30,16,4,26
114984,1063545594,1472.0,24.0,33,9,2,31
114997,1063546076,7853.0,51.0,95,28,2,93
114999,1063546022,52216.0,127.0,28,14,9,19
115000,1063545779,7393.0,37.0,13,11,1,12
115006,1063546007,65734.0,131.0,45,31,8,37
115007,1063546004,56771.0,200.0,64,37,4,60
115011,1063546038,93180.0,194.0,79,65,10,69
115013,1063546033,37669.0,187.0,121,102,9,112
115014,1063545637,41308.0,29.0,11,6,2,9
115015,1063545860,26653.0,59.0,25,21,3,22
115016,1063545845,80280.0,68.0,31,20,3,28
115025,1063546336,5269.0,10.0,8,6,1,7
115028,1063546319,66368.0,84.0,41,25,6,35
115069,1063545994,22940.0,32.0,45,13,8,37
115083,1063545775,76121.0,156.0,129,24,5,124
115084,1063545963,9109.0,65.0,17,8,5,12
115136,1063545927,0.0,0.0,4,0,0,4
115139,1063545725,36037.0,57.0,39,13,6,33
115168,1063546732,175002.0,163.0,148,73,14,134
115169,1063546954,10285.0,27.0,34,25,3,31
115171,1063545840,15529.0,40.0,97,68,2,95
115175,1063546728,106053.0,66.0,50,31,7,43
115179,1063546613,44668.0,41.0,55,29,2,53
115206,1063546272,37420.0,77.0,25,6,10,15
115223,1063546961,45881.0,209.0,43,7,23,20
115252,1063546128,55553.0,116.0,20,4,4,16
115253,1063546126,37216.0,144.0,25,13,3,22
115276,1063546214,4216.0,18.0,8,3,2,6
115306,1063546197,20567.0,105.0,11,1,9,2
115307,1063546664,17601.0,133.0,93,72,5,88
115309,1063546964,0.0,3.0,32,19,0,32
115321,1063546660,14724.0,109.0,30,17,6,24
115330,1063546116,0.0,0.0,1,0,0,1
115332,1063546290,62407.0,14.0,43,21,3,40
115334,1063546839,16746.0,57.0,12,6,7,5
115336,1063546103,8819.0,23.0,4,1,2,2
115338,1063546835,17131.0,65.0,28,19,4,24
115339,1063546102,37512.0,43.0,10,7,1,9
115340,1063546408,36570.0,52.0,40,15,4,36
115342,1063546263,46372.0,121.0,29,23,3,26
115343,1063546257,198508.0,165.0,84,60,10,74
115345,1063546247,33124.0,166.0,14,8,3,11
115347,1063546238,11347.0,14.0,29,25,1,28
115351,1063546228,0.0,0.0,9,5,0,9
115370,1063546167,4237.0,67.0,27,12,2,25
115375,1063546157,78214.0,47.0,31,14,5,26
115376,1063546150,36972.0,107.0,18,8,10,8
115377,1063546305,15005.0,114.0,18,3,1,17
115379,1063546303,39339.0,41.0,25,18,4,21
115381,1063546147,31994.0,165.0,6,3,5,1
115382,1063546141,99536.0,196.0,113,27,13,100
115383,1063546133,21922.0,76.0,4,3,1,3
115388,1063546132,70586.0,55.0,19,11,3,16
115426,1063546527,57572.0,27.0,10,6,3,7
115436,1063546727,20134.0,94.0,54,42,4,50
115455,1063546181,21723.0,42.0,45,33,2,43
115456,1063546179,47583.0,69.0,95,67,5,90
115472,1063546130,21114.0,182.0,22,8,8,14
115504,1063546475,7765.0,77.0,45,30,1,44
115533,1063546510,42027.0,188.0,63,40,9,54
115539,1063546493,130811.0,272.0,79,18,19,60
115541,1063546750,2000.0,20.0,18,9,1,17
115543,1063546505,48802.0,290.0,53,32,7,46
115561,1063546748,9193.0,1.0,5,3,1,4
115591,1063546652,0.0,0.0,16,8,0,16
115605,1063546465,22023.0,110.0,35,18,4,31
115608,1063546461,2300.0,45.0,24,18,2,22
115627,1063546442,57028.0,135.0,51,7,4,47
115629,1063546436,74934.0,47.0,34,8,6,28
115642,1063546499,150798.0,388.0,97,61,11,86
115644,1063546297,115299.0,68.0,12,7,4,8
115652,1063546191,20127.0,295.0,173,94,4,169
115664,1063546183,5165.0,40.0,134,89,1,133
115667,1063547760,37770.0,31.0,40,28,2,38
115669,1063546488,36011.0,74.0,12,6,3,9
115671,1063546483,2594.0,28.0,18,7,2,16
115672,1063546479,1080.0,9.0,30,8,3,27
115728,1063546365,0.0,0.0,6,3,0,6
115739,1063546362,13330.0,18.0,22,10,3,19
115774,1063546360,0.0,39.0,69,32,0,69
115775,1063546349,98541.0,119.0,38,30,5,33
115793,1063546551,8407.0,84.0,358,4,8,350
115794,1063546549,2220.0,49.0,27,6,13,14
115798,1063546547,149968.0,113.0,62,29,7,55
115799,1063546545,56875.0,44.0,41,13,3,38
115803,1063546542,56231.0,119.0,14,3,6,8
115807,1063546430,6697.0,148.0,52,29,3,49
115809,1063546429,23745.0,77.0,65,43,4,61
115810,1063546831,42790.0,98.0,17,6,5,12
115813,1063546426,109992.0,338.0,119,78,9,110
115814,1063546495,126390.0,68.0,60,14,5,55
115817,1063546418,52613.0,178.0,81,56,7,74
115819,1063546713,88078.0,73.0,42,33,3,39
115873,1063546517,20720.0,69.0,48,31,3,45
115888,1063546822,5525.0,11.0,20,10,3,17
115908,1063546710,29672.0,117.0,62,46,5,57
115935,1063546605,0.0,0.0,2,1,0,2
115936,1063546594,67195.0,53.0,54,33,3,51
115939,1063546592,132501.0,163.0,16,8,7,9
115940,1063546571,119584.0,126.0,27,17,5,22
115941,1063546514,446608.0,190.0,25,19,9,16
115955,1063546414,21025.0,47.0,72,60,3,69
115962,1063546540,1306.0,1.0,22,11,1,21
115976,1063546535,8625.0,44.0,15,11,1,14
116003,1063546533,5870.0,59.0,23,15,3,20
116004,1063546529,58238.0,119.0,62,43,9,53
116016,1063546563,33270.0,102.0,126,23,9,117
116017,1063546650,2755.0,166.0,71,25,5,66
116019,1063546647,0.0,1.0,19,15,0,19
116020,1063546640,0.0,1.0,28,22,0,28
116023,1063546626,492.0,7.0,36,22,1,35
116034,1063546556,32030.0,128.0,24,12,4,20
116051,1063546525,98417.0,95.0,37,21,10,27
116079,1063546528,3541.0,272.0,43,16,6,37
116087,1063546722,47594.0,144.0,68,40,6,62
116094,1063546669,28931.0,118.0,62,49,5,57
116096,1063546707,11915.0,57.0,25,18,3,22
116099,1063546705,38875.0,35.0,10,5,2,8
116101,1063546703,67735.0,217.0,59,39,9,50
116104,1063546696,53273.0,72.0,74,42,7,67
116128,1063547167,26406.0,97.0,47,28,4,43
116129,1063547377,23952.0,103.0,35,21,7,28
116133,1063547101,43733.0,289.0,54,40,8,46
116138,1063546520,78025.0,57.0,39,11,7,32
116151,1063546746,5523.0,1.0,16,11,1,15
116177,1063547087,13980.0,84.0,12,9,3,9
116178,1063547084,46529.0,51.0,69,47,2,67
116180,1063547080,15380.0,202.0,9,4,3,6
116181,1063547073,8070.0,82.0,6,3,3,3
116212,1063546691,91028.0,299.0,54,30,10,44
116214,1063546609,0.0,68.0,5,0,0,5
116217,1063546682,87489.0,253.0,143,62,12,131
116241,1063546872,29456.0,187.0,27,18,4,23
116259,1063546618,112828.0,164.0,55,18,7,48
116261,1063546608,106745.0,92.0,27,15,8,19
116264,1063546667,52271.0,191.0,156,114,12,144
116265,1063546738,78309.0,30.0,16,8,2,14
116266,1063546679,85655.0,177.0,137,95,7,130
116269,1063546804,11259.0,95.0,9,4,4,5
116270,1063546621,8991.0,12.0,24,7,6,18
116288,1063547070,53667.0,172.0,22,12,5,17
116387,1063546866,4982.0,34.0,39,31,2,37
116390,1063546863,11808.0,71.0,31,17,4,27
116392,1063546856,0.0,0.0,19,4,0,19
116393,1063546852,0.0,3.0,20,13,0,20
116396,1063546763,59299.0,47.0,22,12,3,19
116408,1063546930,539817.0,273.0,99,41,12,87
116409,1063547775,3767.0,2.0,13,0,1,12
116410,1063546926,10657.0,56.0,24,13,3,21
116411,1063546923,2993.0,38.0,31,18,2,29
116412,1063546912,19584.0,193.0,15,9,5,10
116413,1063546847,8872.0,183.0,55,23,2,53
116422,1063547063,23788.0,154.0,84,55,5,79
116437,1063547604,0.0,0.0,2,0,0,2
116439,1063546752,15567.0,60.0,11,6,3,8
116473,1063546800,49278.0,9.0,25,10,1,24
116474,1063546798,92558.0,35.0,76,58,2,74
116475,1063546794,144650.0,170.0,42,31,8,34
116476,1063546788,55759.0,45.0,18,11,2,16
116477,1063546785,33203.0,101.0,24,13,8,16
116479,1063546783,110519.0,41.0,45,29,3,42
116480,1063546781,0.0,1.0,7,4,0,7
116481,1063546778,49427.0,180.0,37,19,5,32
116500,1063547732,67697.0,62.0,23,8,4,19
116509,1063547602,28886.0,61.0,19,11,3,16
116514,1063547052,64220.0,49.0,29,15,3,26
116515,1063547036,104630.0,124.0,67,36,8,59
116516,1063547060,32218.0,24.0,42,18,4,38
116518,1063547034,9966.0,33.0,36,12,4,32
116519,1063547039,0.0,0.0,2,1,0,2
116521,1063547371,51458.0,214.0,30,17,13,17
116522,1063547369,7062.0,47.0,20,11,5,15
116524,1063547046,0.0,0.0,1,0,0,1
116526,1063546907,0.0,0.0,17,11,0,17
116528,1063546904,2735.0,8.0,3,1,1,2
116529,1063546898,55864.0,100.0,57,23,10,47
116541,1063547363,66492.0,98.0,25,16,6,19
116542,1063547354,25291.0,61.0,21,11,4,17
116572,1063547698,1752.0,5.0,36,6,1,35
116593,1063546993,0.0,1.0,11,2,0,11
116612,1063547346,33917.0,5.0,49,32,2,47
116622,1063547007,112154.0,123.0,38,17,10,28
116623,1063547711,6623.0,8.0,4,2,1,3
116630,1063547690,1271.0,12.0,21,4,1,20
116631,1063547000,75570.0,170.0,34,15,14,20
116633,1063547728,64459.0,353.0,57,24,13,44
116635,1063547344,7991.0,34.0,25,14,3,22
116636,1063547335,0.0,1.0,83,56,0,83
116639,1063547315,19000.0,9.0,27,15,1,26
116643,1063547309,21185.0,108.0,15,5,3,12
116645,1063547301,12294.0,43.0,40,27,4,36
116668,1063547025,39043.0,161.0,130,62,10,120
116670,1063547019,0.0,0.0,5,3,0,5
116671,1063547491,6470.0,182.0,60,38,2,58
116673,1063547521,8750.0,40.0,43,28,3,40
116674,1063547497,50414.0,108.0,105,83,6,99
116676,1063547010,6844.0,3.0,15,6,2,13
116726,1063547142,28694.0,74.0,14,4,5,9
116741,1063547217,35864.0,126.0,41,31,7,34
116742,1063547215,0.0,0.0,3,1,0,3
116743,1063547211,223878.0,151.0,11,4,7,4
116747,1063547209,29808.0,78.0,11,5,5,6
116749,1063547207,118229.0,160.0,57,40,6,51
116753,1063547202,6003.0,8.0,12,8,2,10
116796,1063547273,2109.0,38.0,39,32,2,37
116807,1063547218,18436.0,345.0,82,40,3,79
116808,1063547232,16674.0,47.0,79,36,3,76
116809,1063547234,28148.0,43.0,68,31,3,65
116811,1063547243,42832.0,205.0,44,13,8,36
116813,1063547124,18877.0,129.0,49,25,5,44
116840,1063547199,48183.0,61.0,25,20,3,22
116844,1063547162,42976.0,56.0,67,45,3,64
116845,1063547295,0.0,0.0,7,5,0,7
116846,1063547584,178002.0,223.0,37,17,6,31
116847,1063547173,1308.0,12.0,24,10,3,21
116848,1063547582,35903.0,2.0,14,11,1,13
116849,1063547176,0.0,0.0,1,0,0,1
116850,1063547194,113575.0,124.0,30,21,7,23
116851,1063547186,91728.0,150.0,34,13,6,28
116852,1063547580,8812.0,118.0,25,5,6,19
116853,1063547169,28381.0,55.0,19,11,2,17
116856,1063547093,18200.0,44.0,18,13,3,15
116857,1063547649,36192.0,42.0,24,12,4,20
116858,1063547574,62945.0,30.0,31,21,2,29
116859,1063547670,11930.0,149.0,104,65,5,99
116860,1063547564,36703.0,181.0,34,23,3,31
116861,1063547666,22360.0,110.0,64,34,3,61
116869,1063547133,0.0,0.0,2,0,0,2
116872,1063547664,15398.0,19.0,19,10,2,17
116881,1063547128,16898.0,116.0,22,13,4,18
116882,1063547656,0.0,0.0,2,0,0,2
116901,1063547409,84694.0,282.0,83,46,7,76
116902,1063547404,126454.0,170.0,74,54,11,63
116903,1063547397,143227.0,36.0,18,11,8,10
116905,1063547390,9701.0,57.0,13,7,6,7
116931,1063547197,3911.0,55.0,11,10,3,8
116965,1063547453,42132.0,354.0,96,48,3,93
116966,1063547441,0.0,8.0,51,33,0,51
116973,1063547437,0.0,2.0,17,13,0,17
116975,1063547420,39149.0,284.0,164,57,10,154
116977,1063547413,106211.0,199.0,59,38,8,51
116985,1063547488,44042.0,34.0,32,19,1,31
116986,1063547481,80998.0,133.0,64,35,6,58
116988,1063547477,44042.0,36.0,34,21,1,33
116989,1063547462,44149.0,60.0,42,25,2,40
116990,1063547457,47960.0,44.0,23,11,3,20
117013,1063547777,15306.0,67.0,16,11,3,13
117015,1063547781,5949.0,30.0,23,12,3,20
117016,1063547790,10584.0,26.0,43,36,1,42
117017,1063547264,12075.0,30.0,30,23,3,27
117019,1063547250,2123.0,11.0,43,34,1,42
117021,1063547278,69434.0,25.0,113,22,3,110
117022,1063547274,0.0,36.0,77,40,0,77
117024,1063547225,12031.0,34.0,131,59,2,129
117057,1063547684,54673.0,188.0,37,8,12,25
117107,1063547598,0.0,2.0,24,11,0,24
117108,1063547588,0.0,0.0,2,0,0,2
117151,1063547679,8851.0,20.0,48,29,4,44
117165,1063547387,69545.0,97.0,5,3,2,3
117206,1063547560,11969.0,69.0,27,13,6,21
117214,1063547556,24700.0,90.0,47,43,2,45
117216,1063547551,88499.0,164.0,92,46,5,87
117217,1063547541,35987.0,75.0,67,22,5,62
117220,1063547532,0.0,8.0,27,16,0,27
117222,1063547528,15092.0,69.0,53,34,3,50
117223,1063547525,86710.0,82.0,74,46,3,71
117226,1063547648,12547.0,62.0,97,46,4,93
117228,1063547636,14444.0,17.0,82,58,3,79
117229,1063547626,25006.0,152.0,32,20,6,26
117249,1063547623,0.0,17.0,33,17,0,33
117250,1063547616,47284.0,112.0,58,27,9,49
117252,1063547611,1173.0,2.0,51,16,1,50
133683,1063527603,204.0,98.0,43,10,1,42
37135,1063522494,2559.0,258.0,87,39,2,85
37224,1063522474,39218.0,95.0,92,29,9,83
37494,1063522486,83201.0,348.0,90,36,12,78
37626,1063522505,20653.0,99.0,56,34,2,54
37636,1063522498,232611.0,143.0,81,71,7,74
37684,1063522483,251403.0,123.0,36,11,10,26
37724,1063522513,40507.0,98.0,103,54,5,98
37821,1063522555,3142.0,32.0,87,33,1,86
38099,1063522517,63111.0,189.0,34,23,10,24
38121,1063522616,41442.0,99.0,61,20,3,58
38125,1063522538,31200.0,187.0,53,14,5,48
38325,1063522542,61322.0,45.0,53,46,3,50
38575,1063522604,30953.0,24.0,8,5,2,6
38829,1063522661,0.0,0.0,1,0,0,1
38976,1063522608,53324.0,205.0,55,22,12,43
39115,1063522639,30334.0,91.0,78,53,6,72
39236,1063522634,85462.0,108.0,126,77,6,120
39294,1063522655,0.0,0.0,58,44,0,58
39389,1063522643,42648.0,59.0,106,77,4,102
39721,1063522648,70265.0,73.0,38,24,7,31
39944,1063522762,24162.0,180.0,107,48,3,104
40061,1063522659,36043.0,194.0,76,54,7,69
40099,1063522789,131565.0,181.0,31,5,11,20
40141,1063522721,66644.0,476.0,230,125,13,217
40180,1063548139,186746.0,84.0,26,20,5,21
40207,1063522711,112458.0,83.0,38,9,7,31
40312,1063522671,27603.0,249.0,116,22,4,112
40330,1063522749,94354.0,32.0,61,28,2,59
40734,1063522925,8230.0,86.0,50,26,2,48
40778,1063522732,104122.0,207.0,50,30,12,38
40810,1063522877,9571.0,57.0,119,36,2,117
40811,1063522746,64762.0,56.0,17,8,3,14
40876,1063522856,471592.0,607.0,121,64,22,99
40892,1063548345,1751.0,8.0,10,1,1,9
40938,1063522887,6080.0,94.0,56,12,5,51
40949,1063522829,269447.0,104.0,56,21,8,48
40991,1063522822,0.0,16.0,86,62,0,86
41166,1063523000,96801.0,155.0,18,12,5,13
41194,1063522848,65984.0,172.0,69,43,9,60
41727,1063522907,77759.0,9.0,16,3,2,14
41738,1063522949,90373.0,32.0,22,5,6,16
41903,1063523078,0.0,0.0,17,2,0,17
41918,1063522943,80231.0,85.0,73,40,11,62
41923,1063522865,91772.0,114.0,37,16,4,33
41954,1063522956,17288.0,73.0,67,54,1,66
42106,1063522897,1378.0,179.0,40,23,3,37
42183,1063522903,11450.0,25.0,72,23,2,70
42190,1063548496,92082.0,80.0,43,31,4,39
42243,1063522969,0.0,2.0,25,2,0,25
42323,1063522964,4043.0,39.0,38,23,2,36
42476,1063522962,0.0,2.0,46,18,0,46
42541,1063522940,22418.0,214.0,49,29,5,44
42843,1063522966,12322.0,45.0,43,19,2,41
43288,1063523182,133148.0,401.0,54,33,12,42
43390,1063548520,64872.0,60.0,48,8,2,46
43423,1063522996,45704.0,119.0,53,23,6,47
43464,1063522973,36919.0,487.0,17,9,7,10
43535,1063522992,58880.0,280.0,50,20,5,45
43545,1063523061,90.0,79.0,42,36,1,41
43593,1063523015,24150.0,430.0,33,10,10,23
43813,1063523025,18055.0,177.0,108,30,3,105
43870,1063523051,4292.0,2.0,24,13,1,23
43893,1063523065,26470.0,60.0,50,39,4,46
44051,1063523073,0.0,9.0,54,24,0,54
44086,1063523089,107227.0,54.0,17,9,5,12
44186,1063523095,24690.0,53.0,95,54,2,93
44187,1063523115,1492.0,4.0,32,25,1,31
44256,1063523132,77857.0,96.0,43,22,5,38
44268,1063523079,0.0,28.0,72,3,0,72
44385,1063523196,10290.0,315.0,137,20,33,104
44676,1063548744,105270.0,62.0,25,4,4,21
44682,1063523157,68244.0,29.0,8,2,1,7
44973,1063523164,42603.0,120.0,58,28,3,55
45164,1063523119,0.0,3.0,23,9,0,23
45259,1063523248,1075.0,16.0,17,12,1,16
45263,1063523174,0.0,0.0,5,4,0,5
45472,1063523226,16533.0,34.0,23,12,5,18
45539,1063548736,29603.0,174.0,97,49,10,87
45653,1063548747,9058.0,15.0,45,42,1,44
45685,1063523213,85231.0,358.0,52,26,9,43
45686,1063523190,35464.0,121.0,116,45,2,114
45700,1063523376,110941.0,180.0,63,31,9,54
45733,1063523218,34793.0,130.0,19,3,8,11
45740,1063523234,54976.0,169.0,107,27,6,101
45787,1063523294,16778.0,40.0,31,3,8,23
45808,1063523240,168995.0,85.0,24,3,8,16
45825,1063523274,25648.0,14.0,7,3,2,5
45843,1063523269,53479.0,257.0,125,83,4,121
45847,1063523277,4619.0,37.0,23,8,4,19
45944,1063523257,4077.0,65.0,28,10,2,26
46187,1063523335,32353.0,27.0,42,10,5,37
46276,1063523311,0.0,0.0,61,49,0,61
46684,1063523361,9042.0,37.0,35,8,2,33
46889,1063523323,29362.0,70.0,18,4,6,12
47048,1063523449,0.0,1.0,40,23,0,40
47306,1063523332,119975.0,222.0,64,15,13,51
47435,1063523350,1168.0,28.0,41,31,2,39
47823,1063523354,0.0,0.0,18,7,0,18
47830,1063523348,50102.0,255.0,564,15,14,550
47933,1063523398,37608.0,77.0,35,23,4,31
47938,1063523444,98892.0,71.0,55,31,5,50
47973,1063523356,8022.0,37.0,27,23,2,25
47978,1063523341,6209.0,101.0,51,11,8,43
48200,1063523465,65810.0,123.0,18,4,4,14
48263,1063523392,80292.0,301.0,22,6,13,9
48300,1063523411,0.0,1.0,12,10,0,12
48370,1063523563,38119.0,98.0,93,44,5,88
48387,1063523381,27666.0,61.0,50,30,3,47
48390,1063523581,321756.0,271.0,65,36,14,51
48570,1063523422,36867.0,29.0,25,7,2,23
48701,1063548927,109216.0,121.0,59,29,7,52
48764,1063523460,53671.0,231.0,34,21,7,27
48884,1063523498,12494.0,44.0,10,3,5,5
49027,1063523502,239717.0,247.0,258,53,12,246
49051,1063548991,1777.0,155.0,82,57,3,79
49058,1063523488,170550.0,424.0,97,36,13,84
49065,1063523491,0.0,90.0,52,30,0,52
49114,1063523548,0.0,5.0,49,43,0,49
49149,1063523494,11263.0,22.0,16,9,2,14
49162,1063523514,0.0,84.0,74,29,0,74
49173,1063523545,67368.0,442.0,84,37,6,78
49194,1063523528,33315.0,143.0,42,17,6,36
49282,1063523521,6836.0,134.0,28,25,1,27
49302,1063523524,52265.0,288.0,69,24,3,66
49342,1063523530,0.0,1.0,13,11,0,13
49352,1063523578,0.0,2.0,40,13,0,40
49395,1063549019,60906.0,54.0,6,2,4,2
49398,1063523537,37969.0,34.0,40,10,2,38
49433,1063523552,150876.0,50.0,17,12,5,12
49441,1063523570,2162.0,94.0,27,14,3,24
49504,1063523589,168471.0,133.0,29,11,8,21
49805,1063523592,1456.0,35.0,181,28,4,177
49856,1063523597,0.0,0.0,24,9,0,24
49885,1063523616,68783.0,216.0,107,55,2,105
50031,1063523665,1169.0,6.0,73,40,1,72
50032,1063549075,108586.0,240.0,81,44,13,68
50051,1063523626,0.0,0.0,30,5,0,30
50065,1063523682,27549.0,112.0,44,13,8,36
50224,1063523648,211562.0,278.0,104,70,12,92
50235,1063523655,6164.0,97.0,65,37,2,63
50247,1063523679,6413.0,80.0,70,39,1,69
50252,1063523640,187133.0,217.0,171,43,10,161
50255,1063523634,0.0,13.0,20,6,0,20
50609,1063523661,93274.0,354.0,50,18,17,33
50873,1063523686,14287.0,56.0,16,8,2,14
51105,1063549175,21171.0,40.0,22,15,2,20
51215,1063523748,3257.0,29.0,17,8,2,15
51221,1063549246,34267.0,43.0,66,56,4,62
51256,1063523691,0.0,122.0,20,7,0,20
51268,1063523798,0.0,32.0,37,19,0,37
51390,1063549213,64188.0,43.0,26,4,2,24
51401,1063523710,11882.0,65.0,18,1,5,13
51432,1063549576,45085.0,57.0,25,8,4,21
51504,1063523705,14458.0,26.0,5,3,2,3
51510,1063523695,125289.0,271.0,41,26,9,32
51766,1063523802,2225.0,9.0,22,16,1,21
51796,1063523725,62948.0,53.0,63,43,4,59
51802,1063523786,5674.0,48.0,13,3,3,10
52181,1063549223,707333.0,531.0,126,54,23,103
52225,1063523779,23099.0,42.0,77,46,4,73
52381,1063523767,0.0,139.0,89,16,0,89
52391,1063523741,97304.0,99.0,25,17,5,20
52472,1063523755,444.0,40.0,18,13,1,17
52529,1063523760,16516.0,63.0,64,32,4,60
52583,1063523771,2049.0,23.0,142,18,1,141
52895,1063523813,19001.0,34.0,30,9,4,26
53049,1063523791,243397.0,232.0,86,17,12,74
53151,1063523897,1362.0,63.0,22,4,2,20
53211,1063523878,37509.0,141.0,18,4,3,15
53245,1063523856,0.0,97.0,82,25,0,82
53269,1063523844,0.0,4.0,19,12,0,19
53290,1063523838,5021.0,92.0,96,24,1,95
53379,1063523804,79283.0,35.0,14,3,5,9
53575,1063524041,24043.0,326.0,77,40,6,71
53656,1063523834,0.0,13.0,54,37,0,54
53697,1063523861,17960.0,10.0,5,1,2,3
53722,1063523874,87296.0,102.0,83,39,10,73
53826,1063523968,9035.0,70.0,20,7,2,18
53936,1063523900,7343.0,103.0,26,20,6,20
54249,1063523928,217486.0,147.0,58,9,8,50
54377,1063549340,43794.0,224.0,45,29,12,33
54480,1063523907,0.0,0.0,1,0,0,1
54492,1063549343,589.0,13.0,15,13,1,14
54708,1063523991,30083.0,58.0,26,11,6,20
54798,1063523932,3179.0,5.0,20,0,1,19
54830,1063523949,1305.0,87.0,71,19,3,68
54866,1063523979,19554.0,23.0,16,2,2,14
55019,1063523985,52608.0,215.0,87,44,10,77
55047,1063524009,147501.0,217.0,63,47,10,53
55069,1063524093,157.0,2.0,10,4,1,9
55074,1063549403,130272.0,243.0,82,53,18,64
55509,1063524025,64379.0,36.0,53,18,3,50
55544,1063523994,2315.0,12.0,41,25,1,40
55817,1063524023,17357.0,60.0,31,14,3,28
55850,1063524030,0.0,0.0,15,0,0,15
55891,1063524049,1040.0,14.0,88,54,1,87
55909,1063524012,42211.0,149.0,14,7,6,8
56112,1063524088,32360.0,21.0,4,2,2,2
56219,1063524051,0.0,15.0,68,33,0,68
56320,1063524058,4196.0,116.0,17,10,4,13
56380,1063524063,128945.0,68.0,41,35,6,35
56400,1063524070,358433.0,236.0,73,42,13,60
56519,1063524141,710.0,60.0,17,7,1,16
56551,1063524106,5762.0,16.0,14,5,2,12
56760,1063549580,42709.0,94.0,51,11,4,47
56950,1063549561,162748.0,123.0,92,64,10,82
57147,1063524112,122660.0,110.0,38,13,4,34
57319,1063524169,29422.0,232.0,68,18,13,55
57320,1063524156,0.0,0.0,13,6,0,13
57551,1063524127,15107.0,14.0,45,37,2,43
57878,1063524199,51666.0,226.0,239,4,24,215
57883,1063524161,180038.0,125.0,23,4,7,16
58176,1063524173,1200.0,11.0,68,55,2,66
58433,1063524185,5725.0,82.0,41,20,2,39
58634,1063524214,7068.0,15.0,3,0,1,2
58644,1063549663,67155.0,37.0,17,13,5,12
58779,1063549695,56187.0,51.0,30,23,6,24
59003,1063524210,22488.0,2.0,7,0,1,6
59039,1063524225,194394.0,54.0,11,6,4,7
59041,1063525248,60642.0,25.0,90,27,7,83
59135,1063524219,62103.0,64.0,31,18,6,25
59140,1063524232,198213.0,253.0,111,42,17,94
59293,1063524240,21041.0,351.0,49,23,5,44
59664,1063524326,706.0,2.0,29,22,1,28
59671,1063524230,18049.0,46.0,114,23,3,111
59677,1063549709,1264.0,92.0,94,28,2,92
59982,1063524252,7587.0,166.0,13,4,2,11
60059,1063524286,569422.0,234.0,108,49,19,89
60072,1063525118,33879.0,32.0,15,6,1,14
60077,1063524274,0.0,25.0,62,31,0,62
60154,1063524336,158439.0,147.0,20,12,8,12
60157,1063524430,65820.0,342.0,94,48,10,84
60176,1063524319,31915.0,54.0,87,38,3,84
60184,1063549703,293300.0,177.0,48,23,13,35
60276,1063524284,0.0,0.0,3,1,0,3
60329,1063524302,14093.0,112.0,30,13,4,26
60335,1063524295,180747.0,125.0,88,20,9,79
60487,1063524330,71411.0,75.0,83,38,5,78
60619,1063524347,19849.0,102.0,48,24,3,45
60691,1063524313,43592.0,64.0,66,37,4,62
60724,1063524373,26621.0,48.0,56,6,12,44
60749,1063549786,101593.0,247.0,15,8,9,6
61167,1063524364,190922.0,323.0,112,57,19,93
61478,1063524408,0.0,4.0,7,1,0,7
61486,1063524377,107752.0,186.0,73,27,5,68
61757,1063524420,169351.0,238.0,39,23,8,31
61926,1063524390,0.0,11.0,4,2,0,4
61959,1063524391,64748.0,63.0,22,8,5,17
62395,1063524463,76513.0,221.0,135,28,16,119
62506,1063524469,66708.0,180.0,59,34,10,49
62507,1063549834,8596.0,25.0,2,0,1,1
62704,1063524440,14418.0,167.0,47,29,3,44
62720,1063524414,124473.0,321.0,101,19,33,68
62732,1063549798,117324.0,181.0,82,51,14,68
62757,1063524411,104080.0,21.0,29,12,2,27
62770,1063524505,45449.0,48.0,11,2,2,9
62801,1063524443,24660.0,17.0,10,3,3,7
62828,1063524557,80940.0,3.0,16,1,2,14
62834,1063524448,73938.0,143.0,35,21,13,22
63089,1063524487,46389.0,118.0,116,9,5,111
63117,1063524633,60967.0,113.0,33,18,4,29
63126,1063549802,58313.0,62.0,11,6,4,7
63158,1063524550,80310.0,36.0,28,11,5,23
63267,1063524490,50853.0,563.0,65,19,8,57
63562,1063524723,98930.0,238.0,33,15,5,28
63567,1063524528,237397.0,102.0,59,36,6,53
63612,1063524553,14139.0,49.0,18,6,2,16
63688,1063549809,36794.0,131.0,71,23,5,66
63722,1063524507,66789.0,92.0,28,12,5,23
63842,1063524818,539.0,79.0,77,42,1,76
64033,1063524570,310610.0,69.0,40,30,7,33
64038,1063524607,35753.0,191.0,25,3,5,20
64053,1063524592,73607.0,363.0,110,79,13,97
64092,1063524669,66971.0,41.0,137,22,8,129
64153,1063524661,36983.0,101.0,48,32,3,45
64161,1063524598,34387.0,314.0,156,50,9,147
64263,1063524690,102290.0,321.0,35,12,7,28
64284,1063524612,8222.0,40.0,30,25,1,29
64402,1063524665,59323.0,64.0,37,32,6,31
64443,1063524603,240414.0,114.0,16,9,7,9
64571,1063524832,6973.0,25.0,12,7,1,11
64630,1063524617,91698.0,65.0,127,58,7,120
65122,1063524684,65467.0,94.0,181,55,26,155
65326,1063524667,0.0,4.0,9,1,0,9
65594,1063524716,69538.0,78.0,65,8,2,63
65655,1063524696,122269.0,105.0,125,79,10,115
65661,1063524688,195428.0,442.0,119,59,13,106
65871,1063524788,22048.0,250.0,66,11,3,63
65986,1063525037,2188.0,159.0,39,16,2,37
66151,1063550316,159036.0,298.0,39,16,18,21
66242,1063524759,119778.0,237.0,104,37,15,89
66881,1063524783,208031.0,180.0,43,22,5,38
66985,1063524781,81691.0,130.0,96,54,4,92
67016,1063524754,44936.0,69.0,131,64,5,126
67118,1063524774,0.0,2.0,9,3,0,9
67163,1063549976,70008.0,217.0,63,30,9,54
67818,1063524828,0.0,2.0,26,15,0,26
68089,1063524835,15966.0,49.0,26,7,3,23
68897,1063524849,85960.0,373.0,105,42,9,96
68982,1063550015,97702.0,95.0,74,34,6,68
69755,1063550031,15.0,25.0,8,4,1,7
69834,1063524906,48778.0,242.0,32,18,4,28
69896,1063550052,44659.0,87.0,56,20,4,52
69914,1063524899,0.0,4.0,73,30,0,73
69934,1063525384,90816.0,188.0,72,52,8,64
69939,1063525004,50474.0,35.0,95,18,1,94
69946,1063524977,0.0,0.0,15,9,0,15
70034,1063525029,187862.0,257.0,31,17,9,22
70168,1063524954,66906.0,77.0,29,17,3,26
70514,1063524984,217203.0,237.0,68,29,22,46
70533,1063525498,42675.0,26.0,54,41,4,50
70553,1063550366,75152.0,326.0,40,22,8,32
70573,1063525005,5729.0,35.0,81,4,3,78
70598,1063525064,0.0,2.0,87,31,0,87
70602,1063525010,441180.0,186.0,77,64,10,67
70620,1063525008,33853.0,176.0,45,16,17,28
70699,1063550074,176725.0,175.0,67,28,9,58
70721,1063525070,40806.0,182.0,71,28,5,66
70749,1063525112,218.0,40.0,50,23,1,49
70911,1063550066,58377.0,47.0,14,8,3,11
70922,1063550059,11561.0,77.0,99,32,4,95
71188,1063525436,27383.0,89.0,69,30,3,66
71315,1063525076,2681.0,24.0,29,21,2,27
71348,1063525074,85174.0,111.0,106,46,9,97
71359,1063550084,420424.0,416.0,130,68,14,116
71360,1063525747,204443.0,197.0,63,24,21,42
71376,1063525695,27338.0,131.0,74,55,4,70
71428,1063525127,1926.0,9.0,85,10,1,84
71477,1063550068,38947.0,95.0,17,6,5,12
71480,1063525097,106071.0,13.0,23,0,2,21
71548,1063525085,28230.0,70.0,18,15,2,16
71593,1063525143,48516.0,163.0,76,37,8,68
71637,1063525105,790.0,15.0,87,59,1,86
71670,1063525361,0.0,46.0,43,6,0,43
71692,1063525679,47813.0,122.0,74,19,19,55
71859,1063525214,162022.0,89.0,142,49,7,135
71896,1063525365,0.0,6.0,129,13,0,129
72223,1063525166,205554.0,334.0,48,17,12,36
72294,1063525728,5668.0,86.0,19,3,2,17
72316,1063525172,2376.0,14.0,69,30,1,68
72425,1063525903,21487.0,3.0,9,5,1,8
72452,1063525371,43342.0,185.0,70,53,8,62
72495,1063525218,2889.0,25.0,16,10,1,15
72585,1063525179,153285.0,240.0,84,65,13,71
72586,1063525242,29236.0,115.0,48,27,5,43
72600,1063525197,0.0,0.0,18,2,0,18
72627,1063525239,82467.0,185.0,49,24,13,36
72671,1063525230,7258.0,2.0,41,20,3,38
72741,1063525576,29130.0,19.0,57,20,5,52
72755,1063525332,5670.0,83.0,18,4,1,17
72795,1063525260,93586.0,86.0,66,40,4,62
72893,1063525553,11707.0,26.0,103,11,2,101
72930,1063525641,95985.0,118.0,38,28,5,33
72998,1063525320,7931.0,142.0,46,18,8,38
73051,1063550137,287179.0,163.0,31,17,13,18
73062,1063525399,9751.0,143.0,19,7,7,12
73107,1063525757,37476.0,195.0,98,43,6,92
73251,1063525408,6016.0,38.0,19,6,3,16
73257,1063525282,21998.0,21.0,30,13,4,26
73258,1063525316,372034.0,461.0,73,62,22,51
73285,1063525537,59229.0,73.0,52,7,6,46
73294,1063525256,7527.0,131.0,67,11,2,65
73307,1063525353,9545.0,32.0,10,5,2,8
73492,1063525299,28402.0,128.0,48,29,6,42
73563,1063525895,27037.0,8.0,14,9,1,13
73697,1063526248,18138.0,36.0,19,14,1,18
73706,1063525341,514328.0,31.0,108,71,9,99
73732,1063550288,82045.0,145.0,27,8,5,22
73786,1063525368,370132.0,190.0,34,23,7,27
73788,1063525607,13772.0,39.0,44,26,3,41
73794,1063525954,0.0,15.0,388,5,0,388
73833,1063525460,106342.0,85.0,57,15,8,49
73919,1063550257,101060.0,290.0,66,42,10,56
73921,1063550112,91808.0,241.0,44,23,10,34
73959,1063525467,14994.0,215.0,29,16,2,27
73963,1063550102,111075.0,165.0,34,23,9,25
74048,1063550268,18290.0,14.0,12,4,2,10
74111,1063525429,4930.0,50.0,94,45,1,93
74143,1063525522,10641.0,238.0,64,21,5,59
74156,1063525444,386307.0,71.0,64,24,7,57
74184,1063525472,272917.0,100.0,65,24,7,58
74191,1063525978,0.0,0.0,16,3,0,16
74197,1063550177,273325.0,297.0,71,52,16,55
74200,1063550148,44251.0,105.0,21,4,3,18
74205,1063525491,264.0,16.0,5,0,1,4
74266,1063525596,78814.0,154.0,61,20,8,53
74279,1063525526,47896.0,108.0,58,38,6,52
74280,1063525585,30595.0,280.0,54,28,7,47
74281,1063525715,6149.0,228.0,17,2,2,15
74321,1063550158,42127.0,232.0,47,23,7,40
74322,1063525478,223956.0,127.0,81,46,12,69
74349,1063525702,37272.0,60.0,50,24,2,48
74357,1063526092,45398.0,234.0,73,57,8,65
74393,1063525549,137609.0,61.0,33,12,5,28
74413,1063525589,21911.0,17.0,18,7,2,16
74420,1063525657,39765.0,77.0,30,6,6,24
74497,1063525488,186514.0,224.0,82,60,12,70
74566,1063525516,58246.0,151.0,75,32,6,69
74568,1063525614,0.0,1.0,11,0,0,11
74590,1063525916,39574.0,60.0,25,5,3,22
74591,1063550174,37012.0,379.0,65,41,7,58
74611,1063525699,0.0,17.0,43,23,0,43
74725,1063528157,58272.0,70.0,46,21,4,42
74757,1063525564,4910.0,6.0,9,4,1,8
74769,1063525544,15291.0,56.0,48,37,3,45
74773,1063550205,164759.0,305.0,27,15,9,18
74784,1063525690,51303.0,46.0,30,19,6,24
74836,1063525561,73617.0,124.0,32,20,7,25
74841,1063550324,53226.0,86.0,22,7,6,16
74910,1063550264,41435.0,39.0,12,5,5,7
74924,1063525668,20836.0,219.0,109,51,2,107
74964,1063525721,17362.0,41.0,61,25,4,57
74995,1063550261,56016.0,80.0,53,12,7,46
74998,1063550276,89401.0,78.0,33,23,6,27
75016,1063525816,2920.0,15.0,22,13,1,21
75031,1063525875,22665.0,184.0,53,23,6,47
75219,1063525748,20159.0,40.0,52,13,2,50
75222,1063525736,27780.0,35.0,39,23,5,34
75232,1063525835,127365.0,211.0,17,6,7,10
75277,1063525818,83181.0,70.0,20,9,6,14
75381,1063525831,15566.0,5.0,2,0,1,1
75383,1063525651,13170.0,13.0,10,3,2,8
75387,1063526061,5570.0,76.0,56,32,2,54
75456,1063525732,0.0,62.0,31,13,0,31
75457,1063525920,63371.0,67.0,131,89,4,127
75460,1063526097,29281.0,136.0,39,14,4,35
75467,1063550355,22504.0,128.0,33,24,4,29
75542,1063525788,13054.0,75.0,59,2,2,57
75609,1063525709,0.0,1.0,11,3,0,11
75643,1063526024,14507.0,33.0,28,6,5,23
75696,1063525762,6946.0,156.0,47,36,4,43
75707,1063526452,16871.0,53.0,56,44,4,52
75736,1063550275,25594.0,39.0,44,19,3,41
75739,1063550309,15383.0,14.0,13,13,2,11
75952,1063525946,11998.0,78.0,24,16,5,19
75965,1063525759,14977.0,80.0,63,27,13,50
75970,1063525907,27000.0,204.0,78,55,8,70
75974,1063526001,81907.0,261.0,79,46,8,71
76100,1063525785,83751.0,89.0,20,8,7,13
76140,1063525779,34034.0,67.0,9,5,3,6
76316,1063526018,352921.0,271.0,78,18,29,49
76387,1063525898,51277.0,437.0,84,44,19,65
76429,1063525841,202859.0,73.0,47,13,11,36
76453,1063525990,0.0,45.0,59,31,0,59
76487,1063525856,11137.0,55.0,25,17,1,24
76497,1063526010,27317.0,78.0,64,33,3,61
76530,1063550340,56500.0,164.0,116,56,8,108
76537,1063526410,2711.0,109.0,51,5,1,50
76540,1063526191,85620.0,167.0,63,14,17,46
76579,1063526331,106134.0,113.0,73,39,10,63
76582,1063525926,40286.0,114.0,71,40,5,66
76616,1063526085,52803.0,163.0,24,7,4,20
76621,1063525891,62872.0,235.0,77,43,7,70
76654,1063550300,47870.0,411.0,70,56,12,58
76676,1063526016,60086.0,330.0,54,39,9,45
76692,1063526545,28372.0,100.0,45,28,5,40
76781,1063526028,30106.0,125.0,58,26,6,52
76865,1063550381,53805.0,110.0,74,49,8,66
76890,1063525972,23773.0,165.0,54,20,8,46
76987,1063526159,11599.0,86.0,72,39,4,68
76989,1063525940,2805.0,14.0,100,48,1,99
77009,1063526056,33766.0,30.0,13,5,6,7
77025,1063525982,22098.0,112.0,56,6,2,54
77039,1063550346,39919.0,39.0,27,18,4,23
77157,1063526188,23021.0,62.0,52,32,3,49
77175,1063526054,75275.0,60.0,38,22,8,30
77226,1063550402,70631.0,172.0,37,28,8,29
77250,1063550358,106173.0,188.0,21,10,9,12
77268,1063526215,54988.0,173.0,29,12,8,21
77629,1063526163,67572.0,110.0,69,35,7,62
77635,1063526104,20227.0,48.0,35,17,6,29
77656,1063550391,317189.0,136.0,84,55,11,73
77664,1063526094,0.0,0.0,14,6,0,14
77677,1063526044,13304.0,31.0,36,8,2,34
77713,1063526134,20626.0,109.0,35,14,4,31
77738,1063550458,413288.0,160.0,64,29,13,51
77811,1063526318,29183.0,383.0,49,9,12,37
77871,1063526337,7232.0,191.0,69,45,10,59
77889,1063526143,13273.0,445.0,71,20,3,68
77973,1063526235,53492.0,201.0,87,56,7,80
77979,1063550469,7182.0,19.0,19,12,2,17
78042,1063526109,518474.0,65.0,37,27,6,31
78047,1063550474,20893.0,58.0,57,25,5,52
78063,1063526147,362564.0,235.0,89,70,11,78
78111,1063526299,20795.0,187.0,59,38,9,50
78139,1063550450,43080.0,225.0,12,4,4,8
78180,1063526291,541955.0,44.0,62,23,4,58
78181,1063526089,6661.0,39.0,21,8,1,20
78270,1063526842,4723.0,74.0,21,8,3,18
78324,1063526377,80332.0,41.0,54,29,4,50
78329,1063526343,15946.0,103.0,49,25,11,38
78332,1063526206,1913.0,17.0,9,0,1,8
78334,1063526225,35407.0,33.0,65,42,7,58
78346,1063526246,74566.0,46.0,64,57,6,58
78352,1063550481,58899.0,279.0,71,43,13,58
78397,1063526174,0.0,4.0,23,16,0,23
78471,1063526183,0.0,0.0,28,11,0,28
78515,1063550504,40929.0,284.0,24,8,11,13
78516,1063526380,201185.0,184.0,43,18,11,32
78519,1063526724,20476.0,80.0,46,34,4,42
78524,1063550499,12433.0,40.0,15,13,4,11
78583,1063550550,46793.0,388.0,43,15,5,38
78623,1063526534,30477.0,208.0,32,13,8,24
78655,1063550487,16451.0,12.0,3,2,1,2
78663,1063526363,2501.0,33.0,85,57,2,83
78738,1063526636,34637.0,101.0,90,34,5,85
78745,1063550623,17384.0,62.0,9,7,4,5
78859,1063550508,41525.0,121.0,56,38,9,47
78884,1063526400,30296.0,53.0,53,25,4,49
78930,1063526474,25524.0,192.0,43,25,3,40
79190,1063526662,242184.0,164.0,54,33,6,48
79235,1063550605,23988.0,121.0,24,5,3,21
79266,1063526539,55177.0,136.0,102,45,8,94
79276,1063526432,98679.0,103.0,35,15,18,17
79283,1063526391,126291.0,86.0,48,24,3,45
79291,1063526395,121854.0,129.0,138,35,7,131
79443,1063550526,36425.0,50.0,33,14,4,29
79509,1063550534,98342.0,163.0,416,30,7,409
79538,1063550690,67400.0,390.0,79,45,12,67
79605,1063526846,6607.0,74.0,57,27,3,54
79619,1063550514,661105.0,155.0,34,8,8,26
79666,1063526507,60435.0,137.0,33,17,3,30
79680,1063550644,107153.0,130.0,27,15,8,19
79685,1063526676,163601.0,101.0,104,54,13,91
79688,1063526856,9519.0,73.0,6,4,2,4
79735,1063526551,35704.0,152.0,22,8,5,17
79765,1063550537,166822.0,75.0,29,6,4,25
79867,1063550669,11893.0,30.0,12,4,2,10
79874,1063526443,21590.0,78.0,40,21,4,36
79876,1063526497,71502.0,184.0,75,9,11,64
79877,1063550587,20907.0,46.0,79,8,2,77
79882,1063526646,93515.0,49.0,105,30,4,101
79884,1063526463,9563.0,99.0,28,19,4,24
79894,1063527430,59705.0,208.0,57,43,11,46
79915,1063526566,8953.0,117.0,48,40,3,45
79946,1063550567,26683.0,140.0,86,38,4,82
79952,1063526487,1316.0,229.0,12,4,1,11
79965,1063550564,63643.0,188.0,52,16,11,41
79970,1063550591,70176.0,70.0,20,14,5,15
79974,1063526620,14747.0,8.0,17,6,3,14
79980,1063550745,40716.0,101.0,29,7,8,21
79983,1063526522,21181.0,70.0,39,18,7,32
79984,1063550638,80606.0,138.0,46,39,9,37
79985,1063526461,13161.0,51.0,53,30,2,51
80016,1063550625,176818.0,58.0,21,20,4,17
80047,1063527333,36894.0,51.0,19,14,2,17
80066,1063526903,77269.0,260.0,33,19,8,25
80072,1063550627,90432.0,297.0,45,41,8,37
80080,1063526805,25797.0,32.0,17,3,3,14
80127,1063526441,11011.0,122.0,119,30,1,118
80141,1063550677,12622.0,109.0,26,13,6,20
80166,1063526563,20937.0,412.0,70,48,5,65
80182,1063526912,124188.0,59.0,34,20,3,31
80188,1063526758,16589.0,50.0,23,13,4,19
80195,1063526832,30509.0,34.0,11,6,4,7
80196,1063526585,9864.0,65.0,39,19,4,35
80197,1063526576,55737.0,154.0,88,65,6,82
80198,1063526682,56224.0,184.0,153,96,10,143
80202,1063526467,57814.0,125.0,107,34,12,95
80236,1063550635,58905.0,51.0,16,12,4,12
80240,1063526607,1888.0,5.0,22,15,1,21
80283,1063526511,4441.0,21.0,42,8,2,40
80284,1063526730,57201.0,346.0,91,61,10,81
80293,1063527060,26122.0,33.0,20,6,2,18
80299,1063526626,10505.0,114.0,43,27,5,38
80306,1063550608,73550.0,89.0,72,46,9,63
80309,1063526503,45602.0,147.0,167,83,7,160
80317,1063526655,39106.0,53.0,57,18,2,55
80395,1063526694,6784.0,58.0,27,18,5,22
80424,1063526595,12067.0,99.0,36,21,8,28
80435,1063526874,94021.0,248.0,193,38,17,176
80437,1063526750,9903.0,51.0,32,10,5,27
80438,1063550640,142344.0,91.0,13,6,3,10
80544,1063526826,10057.0,25.0,5,3,1,4
80570,1063526965,0.0,24.0,7,4,0,7
80579,1063527285,0.0,2.0,12,6,0,12
80598,1063527219,65702.0,117.0,30,12,3,27
80602,1063527588,126280.0,232.0,68,38,9,59
80658,1063526980,123824.0,342.0,94,30,9,85
80769,1063527177,1781.0,86.0,22,12,2,20
80782,1063526705,11803.0,57.0,25,3,5,20
80848,1063526666,216428.0,153.0,65,39,10,55
80886,1063550711,21967.0,81.0,13,3,3,10
80905,1063526794,16007.0,42.0,20,17,2,18
80917,1063526711,48607.0,97.0,71,43,7,64
80931,1063526780,0.0,1.0,35,11,0,35
80932,1063526776,19169.0,86.0,64,45,4,60
80936,1063526862,26584.0,32.0,27,11,4,23
80941,1063526892,2994.0,19.0,90,62,1,89
80956,1063526821,14995.0,36.0,81,5,7,74
80993,1063526800,65261.0,350.0,81,40,9,72
81019,1063550871,32016.0,57.0,14,12,7,7
81059,1063526700,96868.0,118.0,43,24,9,34
81076,1063526703,97913.0,130.0,97,58,9,88
81078,1063550693,69732.0,161.0,25,16,8,17
81097,1063526964,3840.0,9.0,35,3,1,34
81175,1063526885,22124.0,71.0,12,5,4,8
81183,1063526746,73558.0,71.0,32,7,13,19
81187,1063550788,165639.0,174.0,39,21,9,30
81194,1063527135,53051.0,45.0,6,4,3,3
81195,1063526717,12201.0,113.0,86,23,5,81
81197,1063550686,248075.0,111.0,126,23,11,115
81207,1063550784,21283.0,27.0,15,11,2,13
81208,1063527146,61682.0,98.0,44,11,5,39
81222,1063527144,54147.0,149.0,20,13,5,15
81226,1063527141,59635.0,70.0,28,18,4,24
81262,1063527014,28682.0,40.0,24,15,2,22
81277,1063526928,21356.0,120.0,50,31,3,47
81278,1063526945,27395.0,114.0,45,22,4,41
81279,1063526937,31333.0,47.0,69,32,7,62
81281,1063526938,32205.0,192.0,50,43,3,47
81301,1063526818,48034.0,55.0,48,17,3,45
81328,1063527156,13724.0,116.0,21,7,5,16
81336,1063550792,53016.0,157.0,33,23,6,27
81339,1063527154,11990.0,82.0,7,5,1,6
81363,1063527019,16990.0,63.0,32,6,4,28
81398,1063550704,66175.0,211.0,38,24,12,26
81401,1063527002,8122.0,34.0,7,3,1,6
81410,1063527475,12951.0,316.0,30,11,5,25
81417,1063527235,108366.0,17.0,42,24,2,40
81419,1063550861,24251.0,253.0,36,13,3,33
81422,1063527462,8438.0,148.0,114,24,4,110
81450,1063550719,911.0,22.0,12,9,1,11
81452,1063527035,11091.0,54.0,9,5,2,7
81453,1063527116,110359.0,169.0,68,44,12,56
81454,1063550751,4342.0,114.0,38,29,6,32
81458,1063527091,127658.0,164.0,73,46,15,58
81460,1063527105,140718.0,154.0,106,60,12,94
81495,1063550716,40836.0,127.0,25,11,4,21
81496,1063527027,13918.0,150.0,24,11,4,20
81497,1063527031,6655.0,56.0,6,2,3,3
81512,1063550761,97989.0,95.0,45,24,10,35
81525,1063550772,23421.0,52.0,18,16,4,14
81526,1063550763,1985.0,26.0,13,8,1,12
81530,1063550778,351132.0,226.0,49,32,14,35
81565,1063526883,130114.0,40.0,38,2,3,35
81570,1063526853,14508.0,79.0,47,34,1,46
81576,1063550683,110785.0,188.0,172,89,6,166
81580,1063526951,45420.0,361.0,59,34,5,54
81587,1063527211,48512.0,94.0,46,23,4,42
81605,1063527004,24049.0,46.0,28,17,5,23
81608,1063550813,132305.0,274.0,69,29,11,58
81610,1063527265,43290.0,113.0,63,47,6,57
81640,1063550739,56523.0,149.0,12,8,7,5
81641,1063550740,105658.0,84.0,11,3,11,0
81642,1063550730,105376.0,156.0,39,21,9,30
81643,1063550732,16612.0,43.0,15,11,4,11
81661,1063550846,243834.0,78.0,33,22,3,30
81671,1063527160,25221.0,212.0,48,41,4,44
81695,1063527129,8541.0,58.0,16,8,3,13
81739,1063526863,1993.0,426.0,136,55,7,129
81765,1063550805,213830.0,256.0,60,41,11,49
81769,1063527212,86525.0,33.0,33,20,4,29
81774,1063550794,160340.0,142.0,158,55,27,131
81775,1063527218,19191.0,89.0,27,17,6,21
81808,1063527161,25441.0,33.0,14,7,2,12
81810,1063550850,19886.0,91.0,7,4,3,4
81815,1063527418,18019.0,47.0,50,17,3,47
81840,1063527122,30597.0,52.0,9,5,3,6
81842,1063527120,224257.0,60.0,42,33,6,36
81884,1063527147,68792.0,57.0,17,8,3,14
81911,1063526899,92953.0,174.0,31,20,8,23
81915,1063527055,0.0,0.0,47,4,0,47
81916,1063526992,73462.0,33.0,59,30,4,55
81923,1063550858,7618.0,172.0,26,24,4,22
81925,1063527463,51587.0,447.0,30,9,10,20
81929,1063527188,67919.0,272.0,62,26,12,50
81941,1063550814,50606.0,94.0,43,32,5,38
81942,1063527260,12946.0,75.0,46,30,4,42
81944,1063527114,6066.0,73.0,17,5,1,16
81955,1063527378,0.0,0.0,84,5,0,84
81968,1063527023,7417.0,60.0,77,48,4,73
81969,1063550832,109409.0,118.0,53,38,8,45
81972,1063527495,25667.0,235.0,27,17,7,20
81973,1063550889,24774.0,250.0,30,22,10,20
81977,1063550895,41823.0,52.0,12,10,3,9
81979,1063550891,25215.0,139.0,67,44,6,61
81980,1063550885,21096.0,62.0,24,17,3,21
82022,1063527080,73430.0,49.0,8,5,3,5
82063,1063526909,16475.0,140.0,62,33,6,56
82070,1063527515,129391.0,162.0,9,3,4,5
82094,1063550840,112118.0,43.0,26,9,4,22
82161,1063527222,90956.0,337.0,45,22,10,35
82162,1063527041,36062.0,46.0,16,11,4,12
82319,1063527444,1601.0,36.0,39,27,1,38
82468,1063527207,29632.0,42.0,71,10,3,68
82509,1063550882,68000.0,133.0,33,22,7,26
82539,1063527226,86560.0,126.0,51,25,7,44
82550,1063527182,11073.0,46.0,13,4,4,9
82634,1063550809,90363.0,539.0,80,51,9,71
82683,1063527780,84324.0,170.0,91,46,12,79
82686,1063527755,51264.0,48.0,29,18,4,25
82694,1063527761,19597.0,134.0,29,7,3,26
82732,1063529658,28622.0,16.0,48,13,4,44
82736,1063527178,13484.0,31.0,14,2,2,12
82739,1063527660,120278.0,132.0,72,58,10,62
82756,1063527882,0.0,50.0,88,35,0,88
82758,1063527851,29430.0,30.0,27,10,1,26
82908,1063527289,84218.0,163.0,49,14,11,38
83037,1063550910,92106.0,128.0,21,15,4,17
83041,1063550907,100013.0,124.0,32,28,7,25
83043,1063527543,22418.0,39.0,13,7,4,9
83046,1063527548,8904.0,29.0,20,16,3,17
83047,1063527539,35517.0,113.0,60,30,7,53
83048,1063550812,33882.0,117.0,40,21,6,34
83068,1063527489,15418.0,120.0,42,25,2,40
83132,1063550930,351770.0,313.0,62,28,15,47
83144,1063527246,45014.0,102.0,23,9,3,20
83191,1063527355,320.0,41.0,46,34,1,45
83223,1063527560,6509.0,182.0,62,7,3,59
83229,1063527336,7236.0,66.0,78,35,3,75
83236,1063527318,55774.0,88.0,202,23,15,187
83239,1063527453,4685.0,72.0,11,3,4,7
83246,1063527499,31229.0,133.0,64,50,4,60
83254,1063527568,67451.0,76.0,15,10,5,10
83272,1063527273,3106.0,16.0,33,14,2,31
83292,1063550929,56886.0,192.0,15,12,5,10
83300,1063527864,0.0,87.0,11,5,0,11
83302,1063527764,52966.0,57.0,17,13,2,15
83304,1063550897,42693.0,65.0,29,14,6,23
83326,1063527482,993.0,6.0,6,4,1,5
83341,1063550835,94500.0,149.0,77,46,8,69
83362,1063527804,76011.0,74.0,13,10,6,7
83378,1063527283,0.0,4.0,22,7,0,22
83405,1063527254,8501.0,42.0,17,3,3,14
83406,1063527375,38309.0,74.0,125,85,6,119
83410,1063527331,0.0,0.0,3,1,0,3
83415,1063527846,21225.0,28.0,46,20,2,44
83500,1063527413,53251.0,161.0,164,17,4,160
83512,1063550974,46055.0,181.0,20,15,7,13
83516,1063550855,53890.0,81.0,36,19,7,29
83522,1063527442,70362.0,147.0,42,25,6,36
83529,1063527649,5626.0,157.0,81,44,4,77
83538,1063527480,305.0,4.0,93,67,1,92
83547,1063527391,54156.0,225.0,51,35,13,38
83610,1063527738,8218.0,16.0,9,3,3,6
83711,1063527642,6213.0,80.0,106,30,4,102
83712,1063527618,271015.0,281.0,34,14,10,24
83713,1063527633,204.0,21.0,85,10,1,84
83714,1063527595,28015.0,68.0,23,7,3,20
83716,1063550967,1481.0,23.0,21,12,1,20
83717,1063551022,25917.0,45.0,14,11,3,11
83721,1063527555,96911.0,176.0,25,14,8,17
83724,1063550923,17165.0,58.0,66,21,3,63
83730,1063527363,52956.0,160.0,145,39,37,108
83739,1063527576,8735.0,81.0,36,11,2,34
83740,1063527591,7201.0,24.0,20,10,3,17
83742,1063527831,0.0,1.0,2,1,0,2
83744,1063527819,0.0,0.0,19,9,0,19
83745,1063527810,1146.0,72.0,18,5,1,17
83797,1063528166,1116.0,16.0,52,3,1,51
83800,1063527672,39947.0,61.0,53,37,7,46
83803,1063550937,42063.0,59.0,31,15,4,27
83814,1063550980,21269.0,23.0,7,7,2,5
83824,1063550983,51668.0,132.0,18,17,5,13
83882,1063527680,72584.0,145.0,30,12,6,24
83883,1063527675,35867.0,50.0,45,21,5,40
83896,1063527837,76967.0,128.0,31,16,17,14
84062,1063527663,167.0,7.0,4,0,1,3
84118,1063550958,17132.0,14.0,2,1,2,0
84129,1063527703,14165.0,92.0,18,9,7,11
84223,1063527638,1489.0,74.0,65,35,2,63
84230,1063527967,138884.0,165.0,30,21,9,21
84231,1063527974,7167.0,166.0,67,29,5,62
84238,1063527962,509.0,16.0,27,11,1,26
84416,1063528987,58895.0,74.0,42,17,2,40
84453,1063527689,76247.0,109.0,12,8,7,5
84455,1063551040,32041.0,88.0,26,5,7,19
84632,1063527654,25065.0,86.0,52,37,7,45
84639,1063528009,170310.0,47.0,36,23,5,31
84643,1063528487,8372.0,8.0,7,6,1,6
84645,1063528509,7451.0,13.0,10,4,4,6
84648,1063528504,8868.0,190.0,33,25,2,31
84654,1063528500,1503.0,9.0,6,2,1,5
84656,1063551093,15314.0,130.0,30,21,5,25
84685,1063527996,5820.0,93.0,25,5,1,24
84688,1063527993,1653.0,11.0,24,1,1,23
84691,1063527992,2684.0,27.0,28,3,2,26
84693,1063527990,160020.0,172.0,48,20,14,34
84696,1063527981,157798.0,69.0,71,35,4,67
84712,1063528064,0.0,4.0,35,12,0,35
84717,1063550939,2047.0,10.0,15,9,1,14
84718,1063528068,22550.0,43.0,75,19,3,72
84719,1063528057,3960.0,314.0,73,21,7,66
84722,1063528076,38318.0,55.0,120,45,2,118
84726,1063528117,262083.0,123.0,151,46,8,143
84734,1063528104,29367.0,53.0,82,30,2,80
84738,1063528090,693.0,28.0,138,9,1,137
84747,1063527958,18600.0,56.0,44,29,5,39
84748,1063527945,28599.0,313.0,70,55,14,56
84751,1063527730,53152.0,273.0,39,19,7,32
84752,1063527710,33936.0,227.0,67,50,6,61
84754,1063527726,78010.0,35.0,12,6,5,7
84760,1063527955,23235.0,55.0,9,7,4,5
84762,1063528085,3841.0,25.0,92,10,1,91
84764,1063551024,90548.0,168.0,28,14,11,17
84780,1063527699,3721.0,25.0,69,28,1,68
84787,1063527931,83289.0,60.0,36,12,5,31
84788,1063528128,2076.0,5.0,11,3,1,10
84789,1063527935,109452.0,235.0,41,19,8,33
84792,1063527723,0.0,0.0,1,0,0,1
84795,1063527913,132933.0,35.0,43,27,5,38
84796,1063527714,10119.0,31.0,17,7,3,14
84798,1063551006,130163.0,244.0,58,31,15,43
84801,1063527926,80904.0,56.0,100,31,6,94
84804,1063551002,109767.0,32.0,18,10,4,14
84857,1063528227,23162.0,183.0,38,11,5,33
84863,1063528242,44624.0,111.0,35,26,7,28
84865,1063528216,13400.0,98.0,20,11,6,14
84868,1063527787,20583.0,344.0,68,37,2,66
84881,1063527832,25425.0,88.0,22,9,7,15
84893,1063551168,84908.0,209.0,31,25,8,23
84899,1063527843,16963.0,144.0,22,14,6,16
84919,1063527862,7178.0,19.0,59,25,2,57
84920,1063551048,25589.0,53.0,7,2,3,4
84925,1063527978,3953.0,6.0,8,5,1,7
84929,1063527732,42365.0,205.0,38,23,8,30
84934,1063528329,45280.0,211.0,26,17,7,19
84935,1063551078,83020.0,125.0,13,8,6,7
84937,1063551058,246480.0,197.0,17,9,7,10
84939,1063551075,178245.0,142.0,27,17,6,21
84940,1063551067,76036.0,115.0,20,13,6,14
84955,1063528723,54553.0,115.0,64,23,9,55
84957,1063551140,127410.0,177.0,68,46,11,57
84958,1063528729,126303.0,166.0,41,20,7,34
84959,1063551136,170194.0,112.0,64,30,9,55
84960,1063528724,20071.0,247.0,33,11,3,30
84962,1063528205,85226.0,121.0,101,32,10,91
84963,1063528197,18676.0,95.0,33,23,4,29
84967,1063528179,128770.0,214.0,81,40,10,71
84975,1063550963,24782.0,26.0,4,1,2,2
85034,1063528212,67888.0,74.0,50,31,4,46
85064,1063551011,11880.0,133.0,12,10,6,6
85072,1063527903,140724.0,214.0,95,33,5,90
85078,1063528323,0.0,9.0,77,41,0,77
85084,1063527888,73765.0,248.0,61,32,6,55
85088,1063527886,337660.0,172.0,78,48,8,70
85094,1063528170,8507.0,82.0,35,26,3,32
85118,1063527896,9120.0,80.0,81,55,2,79
85121,1063528193,35845.0,194.0,33,16,4,29
85126,1063528188,55747.0,267.0,61,36,9,52
85147,1063527743,913.0,3.0,18,4,1,17
85163,1063551110,69197.0,178.0,49,13,8,41
85165,1063528582,5509.0,42.0,19,6,3,16
85177,1063551116,78884.0,251.0,28,13,13,15
85180,1063551096,23844.0,88.0,25,11,8,17
85181,1063528596,54039.0,86.0,33,10,6,27
85203,1063527797,113673.0,88.0,17,4,10,7
85207,1063527910,590.0,49.0,24,11,2,22
85209,1063529559,10299.0,19.0,7,1,3,4
85216,1063551124,68490.0,199.0,83,46,10,73
85218,1063527911,22643.0,45.0,16,10,3,13
85222,1063550987,94344.0,266.0,52,30,11,41
85228,1063550989,34006.0,115.0,32,13,7,25
85230,1063550970,64743.0,252.0,12,8,7,5
85268,1063528813,52019.0,282.0,86,50,8,78
85269,1063551164,96254.0,190.0,110,60,19,91
85274,1063550954,16069.0,183.0,17,7,4,13
85280,1063528032,101469.0,74.0,67,43,3,64
85298,1063528140,66775.0,680.0,34,9,8,26
85335,1063527815,6700.0,69.0,3,1,1,2
85346,1063528050,0.0,0.0,1,0,0,1
85360,1063527894,83260.0,268.0,98,36,2,96
85363,1063527883,18337.0,48.0,26,6,3,23
85383,1063529245,4696.0,151.0,52,35,6,46
85388,1063528024,9961.0,30.0,4,2,1,3
85390,1063551028,40237.0,103.0,9,6,6,3
85392,1063550995,73014.0,133.0,28,19,9,19
85394,1063528246,11940.0,5.0,18,10,1,17
85395,1063551020,84381.0,46.0,8,4,3,5
85396,1063551012,97185.0,235.0,78,36,11,67
85400,1063528020,26650.0,55.0,38,6,4,34
85401,1063528022,48180.0,136.0,20,9,2,18
85406,1063528015,161434.0,194.0,61,36,12,49
85551,1063528149,10614.0,59.0,29,15,1,28
85562,1063528412,54265.0,62.0,21,14,3,18
85564,1063528406,147118.0,225.0,96,44,8,88
85616,1063528444,34908.0,39.0,25,16,2,23
85623,1063528040,45844.0,68.0,25,13,4,21
85655,1063528114,38464.0,62.0,134,50,2,132
85906,1063528263,78672.0,72.0,64,38,4,60
85910,1063528267,28259.0,53.0,48,29,4,44
85924,1063528258,2781.0,50.0,28,17,3,25
85965,1063551038,65599.0,173.0,18,7,6,12
85966,1063551341,62439.0,51.0,46,9,7,39
85978,1063528965,1822.0,275.0,67,9,1,66
85979,1063528990,5685.0,26.0,18,8,1,17
85982,1063528968,0.0,0.0,1,0,0,1
85986,1063528985,25614.0,314.0,30,2,2,28
85989,1063528978,31776.0,400.0,33,23,4,29
86057,1063529154,26743.0,47.0,26,24,3,23
86064,1063528401,40739.0,101.0,64,47,6,58
86073,1063528386,509218.0,298.0,47,23,13,34
86075,1063528423,72443.0,50.0,43,33,4,39
86082,1063528438,56684.0,46.0,39,24,3,36
86084,1063528403,16714.0,77.0,41,24,4,37
86094,1063528224,0.0,0.0,47,26,0,47
86206,1063528389,9704.0,58.0,12,4,4,8
86224,1063528291,76098.0,72.0,53,30,5,48
86233,1063528300,0.0,2.0,18,6,0,18
86234,1063528294,4328.0,187.0,92,36,3,89
86240,1063529123,16916.0,122.0,29,22,4,25
86244,1063528707,11451.0,262.0,18,8,2,16
86245,1063528705,34937.0,64.0,28,17,2,26
86247,1063528674,43653.0,112.0,11,1,6,5
86249,1063528666,34523.0,57.0,22,11,3,19
86253,1063528715,0.0,0.0,3,2,0,3
86254,1063528700,6546.0,73.0,34,22,2,32
86296,1063528173,5860.0,27.0,46,22,1,45
86316,1063528552,0.0,0.0,6,2,0,6
86319,1063528516,40112.0,148.0,49,35,8,41
86322,1063528528,12724.0,43.0,83,26,2,81
86323,1063528270,0.0,0.0,15,9,0,15
86338,1063528567,18869.0,15.0,24,19,1,23
86345,1063528560,23801.0,46.0,31,24,3,28
86348,1063551089,19556.0,48.0,22,19,4,18
86349,1063528452,140497.0,183.0,56,27,8,48
86350,1063528576,25733.0,102.0,40,24,5,35
86351,1063528461,4832.0,26.0,9,8,2,7
86355,1063528471,0.0,1.0,16,4,0,16
86356,1063551087,83391.0,103.0,36,26,9,27
86367,1063529048,0.0,5.0,164,23,0,164
86374,1063551131,92956.0,197.0,46,29,15,31
86377,1063551193,165137.0,176.0,64,37,9,55
86392,1063528802,103002.0,145.0,50,19,11,39
86460,1063551149,142875.0,132.0,54,33,13,41
86461,1063528320,27983.0,23.0,11,5,1,10
86463,1063551044,28408.0,74.0,30,24,4,26
86472,1063551042,41055.0,182.0,16,8,8,8
86477,1063528829,17745.0,132.0,16,3,4,12
86484,1063529228,25974.0,114.0,69,48,7,62
86485,1063551206,40297.0,160.0,19,18,6,13
86486,1063529231,9081.0,155.0,19,13,3,16
86487,1063529226,54553.0,138.0,62,37,8,54
86488,1063528684,1546.0,6.0,4,0,1,3
86492,1063529856,53535.0,145.0,79,53,6,73
86493,1063528343,7415.0,35.0,34,20,2,32
86524,1063551055,12450.0,26.0,16,4,3,13
86548,1063529013,125048.0,80.0,18,10,7,11
86560,1063528317,32244.0,58.0,22,4,3,19
86562,1063528306,15499.0,200.0,74,30,3,71
86577,1063528302,44014.0,124.0,89,57,4,85
86585,1063528603,61328.0,120.0,46,12,8,38
86586,1063528599,64298.0,140.0,151,77,3,148
86588,1063528601,282.0,181.0,54,10,1,53
86590,1063528608,53763.0,155.0,91,37,4,87
86591,1063528612,32796.0,68.0,22,2,2,20
86604,1063528623,8617.0,220.0,57,38,3,54
86609,1063528628,18792.0,12.0,31,19,1,30
86616,1063528631,10346.0,120.0,38,21,5,33
86630,1063528367,0.0,1.0,29,25,0,29
86634,1063528366,1100.0,27.0,17,11,1,16
86639,1063528360,25722.0,157.0,91,69,2,89
86642,1063528357,5203.0,10.0,57,45,1,56
86669,1063529045,30528.0,48.0,30,14,4,26
86671,1063529030,125812.0,109.0,165,33,9,156
86672,1063551190,12537.0,20.0,29,25,3,26
86717,1063530225,33723.0,12.0,7,1,5,2
86722,1063530212,44131.0,162.0,56,40,12,44
86762,1063528638,40102.0,74.0,57,34,9,48
86763,1063528656,3838.0,38.0,8,1,1,7
86765,1063528642,56006.0,199.0,23,11,5,18
86768,1063528662,41719.0,93.0,53,29,5,48
86770,1063528654,12749.0,124.0,42,27,2,40
86794,1063528767,0.0,4.0,5,1,0,5
86796,1063551146,136129.0,265.0,40,25,9,31
86797,1063528765,42974.0,111.0,58,28,5,53
86798,1063528352,33985.0,69.0,156,79,4,152
86799,1063528754,173681.0,213.0,85,48,8,77
86800,1063528749,87623.0,194.0,26,11,5,21
86801,1063528748,68439.0,212.0,86,43,10,76
86803,1063528744,145278.0,65.0,34,22,5,29
86809,1063529150,115382.0,167.0,75,30,10,65
86810,1063529106,52632.0,132.0,69,41,6,63
86811,1063551202,173883.0,273.0,82,52,11,71
86840,1063528737,38988.0,71.0,94,53,3,91
86843,1063528482,8420.0,168.0,59,13,13,46
86888,1063529320,51044.0,185.0,92,51,10,82
86994,1063551174,4774.0,39.0,6,4,3,3
87006,1063528540,23901.0,39.0,59,46,4,55
87007,1063528532,6950.0,27.0,30,20,2,28
87030,1063529236,120938.0,155.0,49,18,13,36
87034,1063529148,68866.0,157.0,34,12,10,24
87071,1063551197,111815.0,59.0,22,13,6,16
87075,1063528826,82521.0,125.0,153,91,3,150
87079,1063529481,112879.0,267.0,112,63,11,101
87080,1063551271,61816.0,206.0,69,31,7,62
87081,1063528349,8592.0,180.0,39,21,3,36
87082,1063529104,45654.0,267.0,52,25,10,42
87084,1063529477,47164.0,186.0,31,19,6,25
87085,1063551279,13302.0,200.0,35,12,8,27
87112,1063551179,5139.0,23.0,9,6,2,7
87214,1063528833,33108.0,99.0,31,16,7,24
87247,1063529114,6338.0,67.0,57,38,2,55
87251,1063528873,0.0,0.0,21,0,0,21
87252,1063528866,12139.0,14.0,7,4,2,5
87254,1063528846,7810.0,116.0,41,28,3,38
87255,1063528862,2997.0,47.0,39,11,1,38
87257,1063551272,27624.0,81.0,6,5,3,3
87313,1063551161,10858.0,15.0,4,2,2,2
87503,1063529140,63709.0,26.0,31,18,2,29
87504,1063551217,22448.0,270.0,37,8,7,30
87512,1063529000,15255.0,151.0,23,8,11,12
87529,1063551180,62968.0,263.0,49,34,11,38
87532,1063529009,45342.0,48.0,22,13,4,18
87534,1063551185,21051.0,28.0,6,2,5,1
87537,1063528994,27069.0,37.0,25,17,2,23
87543,1063529660,6877.0,108.0,22,12,5,17
87557,1063529667,0.0,0.0,14,7,0,14
87559,1063529675,9537.0,72.0,37,11,2,35
87600,1063528869,29177.0,198.0,20,10,5,15
87609,1063528840,6767.0,71.0,8,4,1,7
87647,1063529470,30109.0,65.0,64,11,11,53
87665,1063528783,69566.0,119.0,32,23,12,20
87669,1063528797,10459.0,5.0,35,14,1,34
87673,1063528772,20808.0,109.0,40,19,5,35
87687,1063528770,3261.0,22.0,20,12,3,17
87769,1063528822,17541.0,53.0,42,18,3,39
87786,1063529682,1512.0,0.0,9,3,1,8
87788,1063529686,13001.0,108.0,114,7,3,111
87790,1063529696,500.0,112.0,11,2,1,10
87797,1063528778,48202.0,150.0,66,29,6,60
87851,1063529162,66987.0,23.0,14,8,2,12
87854,1063529499,44918.0,171.0,42,18,14,28
87865,1063551254,43032.0,41.0,19,11,4,15
87867,1063529398,5134.0,34.0,46,26,2,44
87869,1063551252,45682.0,51.0,36,12,4,32
87872,1063551243,21501.0,51.0,54,30,5,49
87873,1063529442,658484.0,94.0,26,9,5,21
87879,1063529338,10335.0,102.0,15,3,4,11
87897,1063529800,54487.0,126.0,54,15,5,49
87912,1063551297,202543.0,116.0,20,18,10,10
87916,1063528904,52439.0,125.0,79,49,12,67
87919,1063551257,98605.0,118.0,49,32,6,43
87920,1063551222,81697.0,65.0,40,34,4,36
87924,1063529439,39720.0,67.0,49,34,4,45
87946,1063529097,7152.0,52.0,63,53,3,60
87950,1063529082,51953.0,113.0,40,30,4,36
87954,1063529075,119613.0,159.0,69,32,9,60
87965,1063529073,54779.0,155.0,27,20,2,25
87968,1063529065,12175.0,84.0,104,66,4,100
87973,1063529062,8181.0,303.0,122,42,4,118
88019,1063529136,56474.0,107.0,34,14,9,25
88031,1063528853,8762.0,221.0,36,5,4,32
88032,1063529406,33040.0,74.0,37,27,6,31
88033,1063529365,21875.0,46.0,17,9,4,13
88034,1063529350,28824.0,146.0,45,20,6,39
88035,1063529353,0.0,3.0,25,14,0,25
88036,1063529355,18409.0,56.0,23,12,3,20
88038,1063529375,43200.0,200.0,51,24,10,41
88039,1063529385,98238.0,169.0,36,29,5,31
88042,1063551237,42650.0,50.0,10,6,4,6
88044,1063551232,64337.0,195.0,14,7,8,6
88049,1063529268,78755.0,101.0,48,12,11,37
88115,1063529178,0.0,97.0,35,16,0,35
88118,1063528942,12131.0,35.0,9,5,4,5
88120,1063529165,52512.0,23.0,48,27,2,46
88123,1063551214,50421.0,327.0,65,46,7,58
88131,1063529190,43698.0,64.0,76,36,7,69
88132,1063529119,66863.0,134.0,142,53,4,138
88133,1063529197,17459.0,30.0,60,32,4,56
88137,1063528924,10707.0,87.0,53,33,5,48
88138,1063528937,26942.0,32.0,103,65,2,101
88139,1063529180,41301.0,69.0,54,38,3,51
88140,1063528932,55955.0,120.0,100,61,9,91
88141,1063529212,43727.0,133.0,49,14,7,42
88142,1063529239,3879.0,46.0,22,10,2,20
88143,1063529188,26404.0,27.0,38,21,2,36
88146,1063529169,8127.0,25.0,66,33,2,64
88148,1063529020,924.0,26.0,29,16,2,27
88159,1063529528,350800.0,373.0,50,20,4,46
88161,1063529539,465598.0,112.0,30,21,7,23
88168,1063528955,20881.0,33.0,42,21,5,37
88170,1063528952,62271.0,135.0,26,16,7,19
88171,1063528950,189924.0,444.0,62,30,18,44
88172,1063528959,55074.0,155.0,69,35,12,57
88197,1063529253,2684.0,36.0,20,8,2,18
88199,1063528929,274124.0,24.0,69,48,3,66
88201,1063529490,281399.0,147.0,126,33,9,117
88266,1063529052,239835.0,171.0,39,12,5,34
88289,1063529059,41319.0,57.0,44,36,3,41
88298,1063529455,34504.0,30.0,81,67,2,79
88300,1063529452,43301.0,57.0,18,10,6,12
88301,1063551268,55297.0,88.0,26,14,4,22
88303,1063529461,48936.0,278.0,70,55,9,61
88304,1063529448,0.0,8.0,9,5,0,9
88305,1063529393,250594.0,271.0,85,47,9,76
88319,1063529525,1793.0,20.0,21,16,2,19
88322,1063529511,0.0,0.0,7,5,0,7
88324,1063529522,33227.0,48.0,30,13,3,27
88326,1063529513,0.0,79.0,24,16,0,24
88327,1063529501,527.0,86.0,15,8,1,14
88355,1063528921,0.0,8.0,40,21,0,40
88455,1063529288,11064.0,45.0,35,19,3,32
88457,1063551233,47965.0,102.0,20,8,10,10
88501,1063530310,48368.0,59.0,47,21,6,41
88507,1063530915,0.0,17.0,20,11,0,20
88511,1063530919,123575.0,173.0,96,63,9,87
88513,1063530907,1927.0,104.0,25,10,15,10
88527,1063529634,37247.0,186.0,50,10,12,38
88528,1063529608,92478.0,171.0,68,39,8,60
88534,1063529747,125924.0,67.0,46,19,4,42
88539,1063529763,114824.0,6.0,6,3,1,5
88540,1063529625,0.0,9.0,42,25,0,42
88541,1063529759,124427.0,163.0,17,3,5,12
88547,1063529753,114824.0,12.0,36,16,1,35
88550,1063529756,115314.0,11.0,12,7,2,10
88566,1063529553,370538.0,76.0,75,24,5,70
88567,1063529535,382871.0,70.0,54,29,3,51
88568,1063529547,53418.0,59.0,18,14,5,13
88576,1063529767,4011.0,8.0,15,10,1,14
88578,1063529739,63156.0,102.0,50,28,3,47
88583,1063529778,114824.0,7.0,7,5,1,6
88597,1063529612,40951.0,127.0,61,17,11,50
88599,1063529630,63014.0,93.0,46,26,5,41
88611,1063530563,11804.0,169.0,49,26,4,45
88614,1063530528,36256.0,101.0,105,32,6,99
88616,1063530566,15697.0,115.0,97,13,1,96
88650,1063551282,74950.0,225.0,64,54,8,56
88683,1063529657,413181.0,49.0,19,8,6,13
88725,1063551230,21491.0,60.0,40,13,3,37
88726,1063529273,70309.0,80.0,113,69,4,109
88727,1063529295,17496.0,32.0,19,12,2,17
88729,1063529278,17227.0,26.0,36,9,1,35
88731,1063529730,87847.0,251.0,34,15,12,22
88732,1063529720,72769.0,125.0,53,39,6,47
88734,1063529729,47696.0,173.0,34,23,7,27
88737,1063529713,1726.0,7.0,45,36,2,43
88738,1063529717,117953.0,115.0,16,10,4,12
88767,1063529312,17227.0,34.0,21,7,1,20
88820,1063529643,16631.0,144.0,34,19,4,30
88822,1063529635,15342.0,59.0,61,17,4,57
88836,1063529735,0.0,2.0,4,0,0,4
88844,1063529645,9538.0,10.0,43,21,2,41
88845,1063529640,0.0,0.0,9,2,0,9
88848,1063529652,39619.0,104.0,71,42,2,69
88869,1063529632,3369.0,13.0,51,37,2,49
88870,1063529583,12811.0,115.0,24,18,5,19
88871,1063529590,48090.0,115.0,211,50,10,201
88887,1063529581,7804.0,57.0,34,29,2,32
88888,1063529570,4034.0,9.0,10,6,1,9
88896,1063529464,133162.0,59.0,13,4,5,8
88904,1063529600,0.0,1.0,7,2,0,7
88916,1063529708,0.0,7.0,63,32,0,63
88925,1063529648,16149.0,105.0,39,8,3,36
89025,1063530027,21100.0,94.0,30,13,2,28
89278,1063530300,21945.0,124.0,31,19,8,23
89284,1063530111,7629.0,56.0,19,12,2,17
89317,1063530302,4160.0,16.0,25,12,2,23
89318,1063551370,109832.0,117.0,34,21,6,28
89319,1063529908,435.0,14.0,18,11,1,17
89320,1063530643,142257.0,272.0,61,38,15,46
89321,1063529912,0.0,0.0,4,3,0,4
89322,1063529947,125520.0,120.0,59,31,4,55
89324,1063529938,7150.0,56.0,40,24,1,39
89326,1063529934,12246.0,35.0,27,21,2,25
89328,1063529959,62556.0,181.0,98,36,7,91
89333,1063529932,5443.0,82.0,43,17,1,42
89364,1063530217,37231.0,70.0,40,30,8,32
89366,1063530029,119642.0,127.0,51,25,7,44
89369,1063530075,4576.0,10.0,50,31,2,48
89373,1063530218,22026.0,36.0,61,46,5,56
89375,1063530096,38690.0,48.0,19,17,3,16
89377,1063530084,40304.0,86.0,31,11,8,23
89395,1063529794,0.0,0.0,11,2,0,11
89396,1063529783,81579.0,91.0,93,23,3,90
89399,1063529797,0.0,79.0,37,15,0,37
89410,1063529787,23947.0,106.0,26,10,3,23
89418,1063529969,57843.0,65.0,57,33,6,51
89419,1063529991,16981.0,225.0,12,8,7,5
89420,1063529989,54772.0,27.0,32,20,3,29
89422,1063551330,88093.0,103.0,52,38,6,46
89424,1063529983,47941.0,37.0,64,51,3,61
89488,1063530250,64648.0,115.0,25,16,6,19
89489,1063530245,24952.0,133.0,37,29,3,34
89504,1063530252,17836.0,95.0,51,27,6,45
89511,1063529894,0.0,1.0,6,1,0,6
89522,1063529897,62071.0,66.0,51,6,10,41
89525,1063529881,70699.0,125.0,127,8,8,119
89526,1063529889,73043.0,332.0,58,17,17,41
89527,1063531208,65814.0,25.0,35,13,2,33
89561,1063530223,45497.0,49.0,56,45,5,51
89563,1063551311,163661.0,434.0,74,25,20,54
89586,1063530540,5391.0,255.0,121,38,3,118
89592,1063530169,59115.0,102.0,144,77,7,137
89593,1063530154,44541.0,136.0,30,24,5,25
89595,1063530168,22278.0,90.0,27,12,5,22
89596,1063530161,76339.0,122.0,46,29,7,39
89646,1063529790,13053.0,41.0,34,14,2,32
89702,1063530159,24751.0,16.0,15,14,2,13
89708,1063531217,81170.0,55.0,12,7,4,8
89715,1063530050,75330.0,113.0,53,40,9,44
89731,1063530638,10959.0,92.0,36,24,2,34
89755,1063551339,14432.0,33.0,14,13,2,12
89781,1063530704,37330.0,21.0,19,16,1,18
89785,1063530708,38716.0,470.0,42,29,3,39
89839,1063529964,389725.0,192.0,77,40,12,65
89868,1063529872,31323.0,31.0,34,15,5,29
89871,1063529868,27526.0,42.0,27,13,5,22
89874,1063529874,2880.0,8.0,14,4,1,13
89875,1063551307,22534.0,29.0,15,11,4,11
89876,1063530649,268755.0,216.0,100,31,13,87
89877,1063551298,10796.0,97.0,18,14,4,14
89907,1063529840,14640.0,175.0,37,20,4,33
89911,1063529824,3988.0,29.0,20,13,2,18
89912,1063551322,118648.0,111.0,42,29,7,35
89914,1063529977,8121.0,55.0,25,19,6,19
89917,1063529829,27931.0,118.0,52,37,4,48
89919,1063529919,10279.0,131.0,65,38,3,62
89921,1063529847,18253.0,48.0,42,22,4,38
89926,1063530615,0.0,0.0,1,0,0,1
89928,1063529835,43836.0,114.0,26,19,5,21
89929,1063530119,235630.0,91.0,63,41,4,59
89932,1063530145,274996.0,214.0,65,37,8,57
89933,1063530126,213584.0,77.0,42,20,3,39
89935,1063530121,246487.0,111.0,63,29,6,57
89941,1063530138,195877.0,84.0,18,14,3,15
89963,1063551316,23129.0,361.0,102,32,7,95
89983,1063531780,24942.0,23.0,48,42,4,44
89990,1063530636,11724.0,29.0,8,5,5,3
90015,1063530326,24525.0,47.0,32,23,5,27
90040,1063530286,110406.0,165.0,68,39,7,61
90041,1063530948,194015.0,255.0,125,69,11,114
90043,1063530265,79615.0,13.0,9,7,1,8
90047,1063530281,84750.0,33.0,22,14,3,19
90051,1063530288,206134.0,66.0,65,32,6,59
90052,1063530277,202393.0,154.0,80,32,8,72
90055,1063530260,97732.0,43.0,27,14,3,24
90056,1063530279,80305.0,33.0,30,16,2,28
90057,1063531229,41261.0,74.0,11,7,5,6
90059,1063530233,8172.0,65.0,66,52,3,63
90060,1063530227,50263.0,92.0,33,21,6,27
90065,1063530324,78680.0,213.0,76,36,17,59
90077,1063530960,0.0,0.0,5,3,0,5
90080,1063530715,32003.0,55.0,41,35,3,38
90082,1063530194,0.0,0.0,5,4,0,5
90084,1063530711,15276.0,10.0,17,16,1,16
90111,1063530187,29404.0,264.0,87,63,7,80
90204,1063551332,7123.0,54.0,7,5,3,4
90208,1063551335,33745.0,80.0,11,9,4,7
90213,1063530713,35066.0,49.0,11,7,3,8
90214,1063530010,10656.0,86.0,107,76,3,104
90215,1063530006,2054.0,40.0,45,21,1,44
90217,1063530855,47804.0,156.0,26,13,5,21
90248,1063530942,21416.0,151.0,39,26,4,35
90281,1063531471,94327.0,100.0,123,38,9,114
90307,1063530183,68431.0,203.0,38,12,9,29
90314,1063530180,39452.0,54.0,40,20,5,35
90342,1063530613,28087.0,234.0,101,68,6,95
90348,1063530061,500.0,23.0,65,24,1,64
90364,1063529999,42134.0,178.0,66,28,6,60
90380,1063530610,19683.0,70.0,66,48,4,62
90429,1063530723,10236.0,173.0,51,44,6,45
90431,1063530605,2208.0,38.0,12,7,2,10
90443,1063530727,75874.0,27.0,25,19,4,21
90451,1063530477,101485.0,147.0,56,42,7,49
90453,1063530467,3761.0,21.0,5,3,2,3
90454,1063530460,40832.0,131.0,45,5,20,25
90455,1063530432,0.0,0.0,1,0,0,1
90457,1063530446,8215.0,15.0,7,5,1,6
90468,1063530439,41753.0,31.0,14,3,2,12
90471,1063530292,0.0,2.0,30,16,0,30
90477,1063530491,17381.0,88.0,92,58,4,88
90480,1063530854,30449.0,50.0,15,12,4,11
90490,1063530848,30673.0,82.0,16,6,6,10
90493,1063530143,366586.0,62.0,38,19,3,35
90527,1063530171,97416.0,261.0,105,54,16,89
90558,1063530202,6177.0,117.0,416,43,1,415
90594,1063530175,32733.0,31.0,8,4,3,5
90616,1063532289,9849.0,11.0,23,13,2,21
90618,1063532298,84310.0,6.0,10,1,4,6
90639,1063531113,0.0,96.0,15,7,0,15
90677,1063530400,72270.0,215.0,59,16,5,54
90682,1063530362,67270.0,112.0,37,13,7,30
90746,1063530364,14101.0,50.0,22,2,7,15
90754,1063530587,45756.0,38.0,9,5,4,5
90761,1063530545,40996.0,150.0,61,40,4,57
90796,1063530514,0.0,4.0,20,15,0,20
90797,1063530489,10391.0,19.0,64,47,2,62
90799,1063530512,8450.0,27.0,9,6,1,8
90800,1063530516,13037.0,14.0,16,13,1,15
90807,1063551355,70081.0,147.0,54,38,9,45
90840,1063531174,17048.0,10.0,74,12,2,72
90880,1063530377,469.0,246.0,154,58,2,152
90882,1063531839,33199.0,156.0,27,11,8,19
90897,1063531819,20440.0,43.0,27,5,2,25
90933,1063530398,2468.0,13.0,43,11,1,42
90941,1063530374,35265.0,71.0,50,12,4,46
90946,1063530673,77538.0,107.0,113,54,21,92
90947,1063530669,52859.0,130.0,334,47,11,323
90955,1063530660,54608.0,146.0,92,51,11,81
90971,1063530590,41124.0,151.0,17,8,7,10
91016,1063530502,0.0,0.0,17,8,0,17
91020,1063530703,26107.0,43.0,36,22,2,34
91024,1063530701,80900.0,44.0,16,10,4,12
91026,1063530677,5376.0,101.0,200,80,2,198
91028,1063530408,83874.0,284.0,136,79,7,129
91031,1063530699,0.0,4.0,20,16,0,20
91032,1063530696,1754.0,11.0,45,31,1,44
91034,1063530371,43795.0,36.0,37,21,3,34
91036,1063530421,53951.0,129.0,35,17,6,29
91038,1063530412,67512.0,143.0,74,40,7,67
91060,1063532301,9927.0,138.0,15,5,2,13
91065,1063531777,17476.0,27.0,30,13,4,26
91076,1063531531,92846.0,126.0,25,17,11,14
91098,1063530429,58248.0,29.0,64,7,2,62
91109,1063530734,103563.0,135.0,87,50,12,75
91118,1063530386,22102.0,71.0,42,23,3,39
91124,1063530617,4395.0,17.0,18,14,2,16
91165,1063530434,1825.0,39.0,19,17,1,18
91224,1063530747,59293.0,93.0,35,24,4,31
91227,1063531445,4867.0,83.0,27,17,2,25
91231,1063531457,17695.0,212.0,11,5,3,8
91236,1063530894,6427.0,32.0,11,5,2,9
91247,1063531442,114579.0,76.0,22,9,6,16
91252,1063531449,10177.0,179.0,21,9,2,19
91255,1063531452,9151.0,82.0,22,4,3,19
91284,1063530654,192868.0,28.0,52,44,7,45
91302,1063530744,101202.0,164.0,17,10,4,13
91322,1063530347,98954.0,208.0,46,25,10,36
91332,1063531075,25287.0,66.0,65,17,6,59
91333,1063531066,39750.0,167.0,102,45,9,93
91334,1063531060,87660.0,103.0,178,28,10,168
91338,1063531040,2626.0,18.0,7,5,2,5
91341,1063530952,27467.0,39.0,68,38,2,66
91342,1063530333,13256.0,32.0,17,8,2,15
91343,1063531035,141360.0,78.0,20,13,3,17
91349,1063530965,34638.0,65.0,66,51,6,60
91351,1063531529,95819.0,182.0,74,42,8,66
91353,1063530924,16486.0,64.0,11,5,4,7
91371,1063532490,0.0,23.0,56,27,0,56
91378,1063532515,27701.0,70.0,69,54,7,62
91379,1063532522,14255.0,77.0,93,58,4,89
91391,1063532533,24950.0,118.0,34,26,5,29
91396,1063532292,1798.0,95.0,12,7,2,10
91405,1063530979,19094.0,124.0,31,19,5,26
91407,1063530968,57630.0,144.0,110,60,5,105
91408,1063530974,27435.0,630.0,76,34,9,67
91411,1063530981,83211.0,157.0,76,54,8,68
91454,1063530779,26713.0,87.0,19,5,5,14
91457,1063530798,14053.0,95.0,11,7,6,5
91462,1063551399,17190.0,103.0,43,34,5,38
91496,1063531914,5301.0,69.0,17,9,3,14
91516,1063532494,63221.0,149.0,45,26,4,41
91520,1063531524,47845.0,67.0,24,8,5,19
91525,1063551358,53675.0,113.0,26,19,9,17
91526,1063530769,16337.0,29.0,34,25,3,31
91531,1063532486,128343.0,48.0,73,39,5,68
91533,1063530829,4552.0,14.0,77,39,1,76
91537,1063530823,98503.0,305.0,60,24,18,42
91538,1063530780,0.0,2.0,28,12,0,28
91539,1063530932,116270.0,61.0,59,39,4,55
91540,1063530781,2346.0,61.0,7,4,1,6
91541,1063530820,0.0,14.0,45,19,0,45
91543,1063530803,24383.0,19.0,20,14,5,15
91544,1063531464,93512.0,36.0,51,33,2,49
91547,1063530651,1646.0,48.0,48,26,2,46
91560,1063530804,3676.0,32.0,31,15,3,28
91564,1063530929,0.0,3.0,24,11,0,24
91567,1063531057,15876.0,86.0,24,12,3,21
91570,1063530764,109819.0,125.0,106,56,7,99
91575,1063530752,46312.0,359.0,75,35,6,69
91577,1063531107,0.0,7.0,2,2,0,2
91579,1063530813,7946.0,36.0,40,21,2,38
91582,1063531102,1418.0,305.0,84,44,1,83
91583,1063530748,42770.0,37.0,42,23,3,39
91584,1063530808,8607.0,74.0,37,23,2,35
91587,1063531094,1880.0,28.0,10,8,2,8
91588,1063530838,14927.0,98.0,15,1,2,13
91591,1063531324,113851.0,243.0,37,28,9,28
91593,1063531320,181935.0,235.0,33,18,9,24
91597,1063531080,0.0,30.0,58,39,0,58
91601,1063531318,13525.0,132.0,27,9,6,21
91602,1063531315,77981.0,90.0,23,16,6,17
91604,1063531213,93764.0,125.0,33,21,5,28
91605,1063531513,45162.0,115.0,17,7,2,15
91611,1063531469,16664.0,126.0,114,30,7,107
91623,1063530689,0.0,0.0,10,9,0,10
91649,1063530761,70354.0,115.0,99,51,5,94
91665,1063551393,18549.0,65.0,16,9,4,12
91667,1063531814,72297.0,150.0,37,21,8,29
91669,1063531517,102063.0,285.0,46,21,7,39
91679,1063551384,65607.0,189.0,45,17,18,27
91681,1063530843,26338.0,58.0,17,7,5,12
91708,1063531422,36719.0,53.0,30,8,5,25
91721,1063530898,13404.0,82.0,70,20,2,68
91743,1063551407,21090.0,83.0,37,20,6,31
91745,1063532501,3145.0,53.0,66,54,2,64
91747,1063532538,39392.0,14.0,40,35,1,39
91748,1063530983,4035.0,18.0,34,8,2,32
91752,1063532511,2688.0,10.0,13,10,2,11
91753,1063530992,0.0,17.0,42,20,0,42
91755,1063531427,8528.0,87.0,23,15,2,21
91759,1063532510,0.0,0.0,11,8,0,11
91795,1063533244,0.0,33.0,10,6,0,10
91798,1063530881,75585.0,63.0,23,15,5,18
91801,1063531189,93393.0,168.0,23,12,9,14
91803,1063530872,9260.0,13.0,9,3,1,8
91812,1063530883,2046.0,88.0,31,28,1,30
91820,1063531197,10619.0,29.0,16,7,4,12
91821,1063530858,56688.0,102.0,20,16,4,16
91828,1063530870,44689.0,55.0,36,24,4,32
91829,1063531188,15685.0,52.0,31,15,5,26
91830,1063531186,23655.0,135.0,30,8,4,26
91831,1063530864,62030.0,116.0,36,24,5,31
91832,1063530893,76217.0,91.0,21,14,5,16
91844,1063531417,0.0,1.0,5,2,0,5
91847,1063531411,38848.0,83.0,42,28,4,38
91853,1063531401,121052.0,165.0,50,22,6,44
91863,1063531304,19097.0,90.0,18,4,8,10
91874,1063531773,1402.0,103.0,38,35,2,36
91877,1063531013,48247.0,170.0,110,51,11,99
91890,1063531393,0.0,0.0,14,8,0,14
91892,1063531392,0.0,0.0,13,6,0,13
91896,1063531122,42764.0,116.0,194,46,7,187
91897,1063531155,100342.0,82.0,61,15,6,55
91898,1063531389,6003.0,11.0,6,4,2,4
91904,1063551479,59085.0,70.0,25,20,6,19
91905,1063531131,44856.0,193.0,65,44,7,58
91907,1063531128,64738.0,29.0,22,7,4,18
91922,1063531052,411.0,25.0,9,1,2,7
91946,1063531425,166384.0,300.0,77,40,11,66
91948,1063531180,79037.0,121.0,31,6,7,24
91952,1063531465,21051.0,27.0,6,3,2,4
91953,1063551425,50990.0,103.0,35,18,6,29
91973,1063530982,20256.0,37.0,7,2,2,5
91978,1063551382,95947.0,139.0,88,35,18,70
91999,1063551400,19485.0,199.0,29,7,7,22
92004,1063531498,18384.0,30.0,34,25,2,32
92006,1063531501,6629.0,22.0,13,7,2,11
92009,1063551430,141303.0,186.0,73,29,5,68
92013,1063531492,10299.0,81.0,60,27,1,59
92015,1063532673,94175.0,466.0,104,24,10,94
92028,1063531522,22775.0,79.0,36,13,10,26
92045,1063531479,119494.0,78.0,42,17,4,38
92047,1063530989,0.0,0.0,1,0,0,1
92051,1063531518,11601.0,83.0,21,5,3,18
92069,1063531167,15903.0,21.0,35,24,5,30
92070,1063532668,225933.0,154.0,74,23,17,57
92081,1063531347,942.0,17.0,6,4,1,5
92082,1063531797,9459.0,34.0,60,30,3,57
92084,1063551418,36522.0,141.0,104,26,4,100
92094,1063531246,30136.0,170.0,54,43,8,46
92106,1063531747,5462.0,338.0,90,33,1,89
92126,1063531994,516.0,8.0,18,15,1,17
92133,1063531997,38119.0,202.0,70,28,7,63
92143,1063531242,69339.0,212.0,63,28,10,53
92169,1063531808,35230.0,71.0,22,10,5,17
92172,1063531342,19818.0,66.0,8,2,3,5
92173,1063531976,0.0,0.0,11,5,0,11
92177,1063531804,41167.0,83.0,65,48,5,60
92179,1063531745,93942.0,118.0,15,8,9,6
92181,1063532081,0.0,114.0,67,27,0,67
92191,1063531328,4714.0,9.0,8,5,2,6
92192,1063531336,1404.0,142.0,38,7,5,33
92194,1063531335,16091.0,10.0,19,18,2,17
92195,1063531338,4738.0,21.0,4,2,2,2
92196,1063531340,1744.0,39.0,5,1,3,2
92199,1063531221,34103.0,23.0,32,22,3,29
92200,1063531275,141401.0,218.0,136,72,19,117
92202,1063531214,52336.0,116.0,19,8,10,9
92204,1063531282,25784.0,25.0,44,35,1,43
92205,1063531250,31070.0,104.0,91,56,4,87
92207,1063551423,27396.0,52.0,70,60,8,62
92235,1063531474,81907.0,181.0,23,12,5,18
92246,1063531254,2772.0,58.0,14,7,1,13
92253,1063531859,58472.0,220.0,73,55,6,67
92265,1063531850,11340.0,48.0,47,29,2,45
92273,1063531795,43796.0,148.0,40,30,10,30
92277,1063531361,40746.0,150.0,100,62,7,93
92280,1063531355,934.0,24.0,27,19,1,26
92281,1063531383,12853.0,235.0,30,7,5,25
92282,1063531370,8303.0,33.0,11,8,3,8
92285,1063531364,39904.0,182.0,18,10,9,9
92287,1063531350,39752.0,33.0,43,31,4,39
92298,1063533906,34192.0,149.0,31,15,8,23
92303,1063538141,35288.0,35.0,67,35,2,65
92316,1063551412,63668.0,17.0,2,2,2,0
92395,1063531913,64620.0,109.0,19,2,12,7
92548,1063532027,223818.0,98.0,85,47,6,79
92571,1063531907,0.0,0.0,1,0,0,1
92614,1063551460,11849.0,49.0,27,7,4,23
92620,1063531785,242775.0,142.0,38,28,9,29
92629,1063532304,40071.0,72.0,72,60,4,68
92630,1063551509,44547.0,81.0,12,4,5,7
92633,1063532311,15214.0,55.0,36,23,2,34
92638,1063551512,2189.0,13.0,8,5,1,7
92648,1063532308,0.0,9.0,7,4,0,7
92653,1063531923,8270.0,32.0,12,1,2,10
92683,1063531698,5669.0,22.0,22,18,2,20
92684,1063531701,25946.0,81.0,15,11,1,14
92686,1063531683,51116.0,52.0,49,35,3,46
92687,1063551449,26511.0,151.0,60,30,8,52
92688,1063531679,16979.0,149.0,78,50,6,72
92689,1063531686,22909.0,39.0,84,49,3,81
92690,1063531691,15430.0,58.0,66,51,3,63
92691,1063531754,10092.0,50.0,50,23,5,45
92693,1063531863,4715.0,19.0,78,22,1,77
92696,1063531751,54251.0,229.0,27,16,12,15
92697,1063551437,60748.0,188.0,41,31,8,33
92699,1063551435,58154.0,180.0,140,43,12,128
92700,1063531505,4572.0,35.0,6,2,4,2
92708,1063531736,14296.0,144.0,14,11,2,12
92713,1063531727,51128.0,125.0,67,31,8,59
92714,1063533097,3222.0,13.0,29,21,1,28
92716,1063531720,23563.0,27.0,63,31,1,62
92769,1063531718,924.0,43.0,11,4,5,6
92814,1063531562,434760.0,151.0,85,48,13,72
92819,1063531559,929.0,23.0,59,37,4,55
92824,1063531556,0.0,195.0,33,16,0,33
92827,1063531555,0.0,0.0,12,6,0,12
92861,1063532966,4635.0,26.0,22,16,2,20
92866,1063532956,91370.0,269.0,76,55,12,64
92867,1063531708,6724.0,31.0,19,8,2,17
92878,1063531716,19358.0,27.0,47,27,2,45
92879,1063531714,19619.0,88.0,63,20,6,57
92884,1063531710,0.0,0.0,7,5,0,7
92885,1063531904,13640.0,89.0,31,18,3,28
92922,1063531677,0.0,1.0,15,11,0,15
92941,1063531665,1878.0,30.0,24,17,2,22
92944,1063531999,11547.0,99.0,7,2,5,2
92950,1063531661,20929.0,15.0,40,18,1,39
92957,1063531650,1318.0,13.0,7,5,1,6
92964,1063531646,40155.0,22.0,193,28,2,191
92977,1063531637,0.0,0.0,2,1,0,2
92981,1063531633,10500.0,8.0,16,9,1,15
92984,1063531627,18924.0,21.0,10,7,3,7
92990,1063531573,44024.0,53.0,56,34,3,53
92991,1063531580,16793.0,109.0,57,31,4,53
92995,1063531877,61445.0,243.0,18,9,6,12
93002,1063531876,9809.0,3.0,7,1,1,6
93006,1063531584,11618.0,178.0,6,4,3,3
93010,1063531622,13743.0,18.0,40,16,3,37
93023,1063531618,1968.0,32.0,44,26,1,43
93027,1063531609,59655.0,41.0,8,4,3,5
93038,1063531596,0.0,31.0,49,27,0,49
93042,1063531705,9672.0,42.0,59,12,3,56
93046,1063551433,34476.0,98.0,40,18,4,36
93048,1063531539,9720.0,197.0,46,34,3,43
93070,1063532021,37742.0,212.0,92,40,7,85
93072,1063532007,0.0,0.0,3,1,0,3
93077,1063532006,21899.0,70.0,51,31,3,48
93088,1063551463,47383.0,135.0,26,18,5,21
93103,1063551471,295.0,8.0,9,2,1,8
93105,1063531873,12636.0,96.0,17,6,3,14
93121,1063532948,37478.0,160.0,58,38,8,50
93122,1063531991,26908.0,158.0,30,17,7,23
93134,1063532891,820.0,1.0,4,0,1,3
93141,1063532887,1446.0,2.0,5,0,1,4
93150,1063531848,27164.0,85.0,17,9,5,12
93156,1063532391,12537.0,211.0,114,33,7,107
93164,1063532403,16746.0,131.0,53,26,8,45
93166,1063532412,477.0,33.0,42,25,1,41
93174,1063534910,9318.0,8.0,13,4,1,12
93177,1063534899,48994.0,141.0,52,38,8,44
93183,1063531536,89106.0,244.0,45,14,12,33
93189,1063532417,42024.0,52.0,55,22,2,53
93200,1063531840,1946.0,14.0,10,8,1,9
93241,1063534301,72685.0,92.0,48,35,7,41
93256,1063532256,8617.0,25.0,15,11,1,14
93299,1063532264,10876.0,52.0,24,12,5,19
93301,1063532268,5989.0,8.0,26,18,1,25
93325,1063532484,0.0,6.0,35,21,0,35
93335,1063531763,68316.0,191.0,37,17,12,25
93338,1063532658,59099.0,184.0,75,38,8,67
93339,1063532652,39388.0,119.0,30,10,5,25
93342,1063531986,26400.0,18.0,8,6,1,7
93368,1063551515,127287.0,118.0,20,10,7,13
93400,1063531867,10712.0,83.0,48,22,4,44
93424,1063532477,23885.0,120.0,27,20,6,21
93430,1063532645,49971.0,77.0,43,21,6,37
93442,1063532945,20890.0,141.0,31,23,5,26
93459,1063532884,4090.0,15.0,6,3,2,4
93463,1063532356,179.0,9.0,44,21,1,43
93481,1063531966,34944.0,52.0,56,31,6,50
93485,1063531962,50006.0,44.0,79,38,4,75
93486,1063531956,636636.0,226.0,95,65,13,82
93487,1063531953,179118.0,167.0,40,28,6,34
93493,1063531951,69124.0,113.0,73,45,6,67
93494,1063531943,64619.0,76.0,105,52,4,101
93519,1063531940,147699.0,86.0,130,57,7,123
93526,1063531939,27295.0,49.0,14,7,7,7
93529,1063531932,157570.0,113.0,39,21,6,33
93539,1063532270,31484.0,104.0,64,35,3,61
93540,1063532283,10039.0,41.0,27,11,3,24
93542,1063532379,1089.0,21.0,13,3,1,12
93544,1063532244,156534.0,265.0,58,35,8,50
93545,1063532421,0.0,8.0,55,24,0,55
93547,1063533354,42634.0,80.0,26,10,6,20
93549,1063532462,12290.0,4.0,34,13,3,31
93554,1063532459,176236.0,76.0,49,32,6,43
93555,1063531984,15643.0,70.0,52,15,4,48
93561,1063531981,2939.0,14.0,9,3,1,8
93567,1063532104,5217.0,94.0,10,5,3,7
93568,1063532099,12452.0,97.0,51,41,4,47
93573,1063532091,68116.0,160.0,31,14,6,25
93574,1063532086,3556.0,19.0,35,27,1,34
93577,1063532231,41434.0,26.0,21,14,4,17
93586,1063532229,135609.0,71.0,42,35,5,37
93595,1063531978,9818.0,115.0,38,10,4,34
93597,1063532218,0.0,1.0,14,8,0,14
93598,1063532210,2279.0,21.0,38,27,1,37
93599,1063532084,4531.0,40.0,61,51,3,58
93600,1063532207,5524.0,61.0,26,15,2,24
93612,1063532181,0.0,0.0,34,23,0,34
93614,1063532169,12427.0,27.0,23,17,1,22
93615,1063532833,12813.0,14.0,27,18,1,26
93618,1063532201,4062.0,8.0,21,10,1,20
93620,1063532163,53909.0,203.0,72,41,5,67
93622,1063532869,2123.0,124.0,79,30,6,73
93623,1063532194,22714.0,43.0,43,20,4,39
93624,1063532856,66804.0,35.0,45,31,4,41
93625,1063532831,12813.0,94.0,119,69,1,118
93626,1063532158,318803.0,181.0,161,61,12,149
93628,1063531930,72680.0,77.0,124,43,7,117
93629,1063532152,13558.0,149.0,20,16,3,17
93650,1063532426,32240.0,70.0,64,36,3,61
93652,1063532347,2268.0,3.0,13,10,1,12
93655,1063532339,20506.0,100.0,70,26,3,67
93657,1063532332,42366.0,159.0,67,27,7,60
93676,1063532322,52897.0,139.0,52,27,7,45
93678,1063532367,9907.0,11.0,5,1,1,4
93680,1063531973,0.0,9.0,75,51,0,75
93682,1063532556,4553.0,59.0,73,25,2,71
93684,1063531890,0.0,0.0,4,0,0,4
93690,1063533458,49542.0,266.0,20,9,12,8
93716,1063532449,61587.0,45.0,35,20,3,32
93723,1063551496,126416.0,164.0,31,24,8,23
93725,1063551500,115169.0,71.0,20,12,7,13
93726,1063532135,0.0,0.0,21,1,0,21
93728,1063532112,88662.0,41.0,60,21,4,56
93729,1063532319,9378.0,129.0,26,13,6,20
93730,1063532143,0.0,0.0,1,0,0,1
93731,1063532129,89880.0,46.0,19,14,5,14
93733,1063534159,80318.0,81.0,41,27,6,35
93734,1063533330,6093.0,80.0,62,28,2,60
93746,1063533329,0.0,45.0,30,20,0,30
93753,1063532437,70823.0,312.0,172,41,12,160
93754,1063532116,60688.0,40.0,31,26,4,27
93759,1063532607,185186.0,94.0,43,33,8,35
93760,1063532603,153692.0,65.0,12,3,3,9
93761,1063532597,193864.0,138.0,38,17,12,26
93766,1063533323,0.0,0.0,57,31,0,57
93779,1063532436,23100.0,66.0,41,22,4,37
93786,1063532429,11689.0,23.0,15,8,3,12
93847,1063532824,15073.0,22.0,52,45,1,51
93849,1063532756,1901.0,1.0,6,3,1,5
93851,1063533239,14198.0,13.0,29,15,1,28
93853,1063533233,0.0,8.0,16,9,0,16
93854,1063532745,12570.0,14.0,3,2,1,2
93855,1063532821,0.0,17.0,58,49,0,58
93856,1063533232,36745.0,179.0,25,10,4,21
93859,1063533220,0.0,3.0,25,14,0,25
93876,1063532938,8295.0,94.0,31,23,6,25
93887,1063532432,65886.0,210.0,67,36,7,60
93906,1063532472,8697.0,19.0,32,24,3,29
93909,1063532560,0.0,1.0,10,3,0,10
93913,1063532593,250756.0,100.0,50,33,8,42
93917,1063532583,33014.0,175.0,49,33,5,44
93930,1063532642,24501.0,140.0,14,3,4,10
93931,1063551485,49277.0,298.0,42,25,6,36
93932,1063543020,160440.0,88.0,90,34,10,80
93933,1063532466,0.0,9.0,1,1,0,1
93935,1063533852,32658.0,109.0,69,47,7,62
93965,1063532737,18807.0,70.0,56,20,2,54
93966,1063532735,15963.0,88.0,14,10,3,11
93973,1063533141,2536.0,15.0,24,11,1,23
93974,1063532635,119966.0,93.0,36,19,9,27
93975,1063533128,6956.0,19.0,10,1,2,8
93978,1063532633,11424.0,276.0,76,50,6,70
93980,1063532068,180111.0,76.0,44,22,6,38
93981,1063533131,13149.0,27.0,30,11,2,28
93982,1063532057,53228.0,135.0,37,15,10,27
93983,1063532046,0.0,2.0,8,2,0,8
93985,1063532627,63494.0,81.0,80,57,5,75
93988,1063532037,18700.0,75.0,48,27,6,42
93989,1063551541,56398.0,179.0,76,25,16,60
93990,1063532028,96037.0,231.0,38,18,12,26
93991,1063532624,100.0,5.0,14,9,1,13
93993,1063533515,8330.0,90.0,18,15,3,15
93999,1063533149,8378.0,89.0,5,3,3,2
94002,1063551532,23117.0,17.0,4,1,3,1
94005,1063551538,12154.0,15.0,8,2,2,6
94007,1063533117,28556.0,113.0,44,28,6,38
94024,1063551526,32180.0,66.0,27,9,7,20
94062,1063533164,10668.0,336.0,39,14,3,36
94088,1063534067,106728.0,244.0,98,38,19,79
94091,1063534061,0.0,0.0,19,3,0,19
94092,1063534049,42225.0,106.0,15,4,6,9
94096,1063532572,31967.0,87.0,47,14,12,35
94113,1063533491,39851.0,167.0,68,47,6,62
94114,1063532620,15772.0,252.0,19,8,8,11
94120,1063532611,0.0,1.0,10,10,0,10
94162,1063532811,6841.0,33.0,38,27,3,35
94165,1063551522,67592.0,130.0,38,34,7,31
94197,1063532806,12060.0,128.0,31,19,6,25
94225,1063532465,0.0,67.0,61,34,0,61
94226,1063532874,36036.0,204.0,28,2,7,21
94235,1063532872,8545.0,8.0,4,3,1,3
94237,1063534223,70233.0,54.0,41,24,6,35
94239,1063534212,36174.0,168.0,22,7,8,14
94242,1063534225,2247.0,17.0,14,3,2,12
94244,1063532568,35820.0,107.0,73,44,7,66
94266,1063532592,146723.0,63.0,80,60,2,78
94300,1063532684,85054.0,73.0,136,80,5,131
94307,1063534054,0.0,1.0,10,9,0,10
94322,1063532801,32244.0,52.0,33,17,4,29
94341,1063532562,23712.0,96.0,58,28,5,53
94342,1063532547,10406.0,74.0,41,23,4,37
94348,1063533343,0.0,3.0,13,8,0,13
94349,1063533345,0.0,27.0,22,7,0,22
94351,1063533349,16543.0,54.0,29,12,4,25
94352,1063533332,9508.0,72.0,57,15,3,54
94452,1063532698,15096.0,150.0,20,10,4,16
94454,1063532731,43877.0,75.0,23,12,6,17
94460,1063532713,284.0,216.0,19,3,2,17
94463,1063532706,8595.0,57.0,9,5,5,4
94515,1063532859,21846.0,61.0,108,56,5,103
94516,1063532835,25481.0,159.0,94,60,5,89
94517,1063533054,23677.0,28.0,38,12,2,36
94518,1063533049,32124.0,140.0,42,25,5,37
94560,1063532932,3206.0,110.0,29,9,4,25
94568,1063534299,0.0,19.0,12,10,0,12
94573,1063533108,7367.0,108.0,22,10,7,15
94590,1063533392,29640.0,90.0,64,37,5,59
94593,1063533389,75072.0,91.0,62,32,10,52
94595,1063534022,68873.0,154.0,115,88,6,109
94598,1063533388,10310.0,86.0,13,8,2,11
94601,1063533381,20968.0,247.0,118,73,4,114
94628,1063533372,73567.0,221.0,121,83,13,108
94637,1063533213,959.0,64.0,8,0,3,5
94643,1063532688,76407.0,62.0,37,8,10,27
94646,1063534293,45025.0,25.0,20,13,2,18
94649,1063534046,9259.0,22.0,8,5,2,6
94652,1063533091,0.0,1.0,48,0,0,48
94677,1063533583,27800.0,88.0,34,12,4,30
94684,1063532732,9864.0,5.0,2,0,1,1
94689,1063533082,1703.0,10.0,14,3,1,13
94693,1063533078,19594.0,285.0,49,21,10,39
94695,1063532795,3693.0,22.0,10,2,2,8
94697,1063532785,167700.0,192.0,67,30,10,57
94699,1063532772,96591.0,102.0,99,26,7,92
94702,1063532766,35594.0,136.0,78,33,6,72
94703,1063532764,42807.0,239.0,65,12,7,58
94746,1063533253,45693.0,29.0,17,5,1,16
94747,1063533519,22515.0,141.0,69,23,9,60
94750,1063533243,1638.0,71.0,58,36,3,55
94753,1063535135,22293.0,138.0,15,6,4,11
94780,1063533041,48696.0,127.0,51,21,16,35
94782,1063532992,595.0,240.0,64,27,3,61
94783,1063532990,0.0,5.0,68,0,0,68
94785,1063532988,39668.0,99.0,35,23,3,32
94790,1063532983,98909.0,170.0,105,77,12,93
94814,1063533158,6160.0,41.0,71,21,3,68
94818,1063533153,67609.0,94.0,92,28,7,85
94820,1063533064,28759.0,26.0,25,7,4,21
94836,1063533574,0.0,21.0,78,58,0,78
94838,1063533572,13789.0,282.0,78,47,3,75
94855,1063532976,15215.0,47.0,31,21,3,28
94858,1063533071,10210.0,40.0,16,8,2,14
94878,1063533210,46134.0,50.0,62,37,1,61
94881,1063533151,3915.0,20.0,16,7,2,14
94885,1063533206,47487.0,26.0,24,12,3,21
94886,1063533204,4746.0,36.0,41,22,1,40
94894,1063533191,11872.0,0.0,22,12,1,21
94906,1063534203,0.0,0.0,1,0,0,1
94935,1063534199,26967.0,92.0,12,8,4,8
94958,1063532924,76078.0,140.0,32,17,8,24
94961,1063532923,14015.0,35.0,17,4,4,13
94963,1063532918,95938.0,171.0,45,14,11,34
94965,1063532915,14040.0,16.0,17,7,5,12
94966,1063532901,9605.0,57.0,120,54,2,118
94972,1063534131,36156.0,43.0,13,2,5,8
94989,1063533587,1490.0,17.0,54,41,1,53
94990,1063533593,78638.0,102.0,84,63,7,77
95010,1063533188,0.0,0.0,121,4,0,121
95011,1063533178,15879.0,213.0,73,36,2,71
95028,1063533307,5635.0,4.0,5,1,2,3
95029,1063533305,11999.0,196.0,21,8,2,19
95096,1063533302,164043.0,319.0,34,15,11,23
95097,1063533299,0.0,1.0,6,3,0,6
95098,1063533294,17977.0,22.0,17,10,2,15
95100,1063533614,161348.0,286.0,71,43,17,54
95101,1063533271,103499.0,79.0,39,7,4,35
95102,1063533616,20592.0,107.0,42,25,3,39
95103,1063533620,116862.0,291.0,78,57,6,72
95106,1063533268,6180.0,17.0,8,1,1,7
95108,1063533470,3978.0,13.0,46,24,2,44
95113,1063534596,34297.0,136.0,80,37,11,69
95119,1063533628,19879.0,46.0,7,3,3,4
95126,1063534591,6012.0,77.0,41,27,5,36
95138,1063534264,14720.0,62.0,24,14,5,19
95159,1063533464,8585.0,15.0,81,41,3,78
95165,1063533172,10804.0,154.0,55,28,4,51
95166,1063533513,44361.0,79.0,54,36,7,47
95170,1063534680,17315.0,183.0,144,55,5,139
95186,1063533840,0.0,14.0,103,29,0,103
95187,1063533803,0.0,15.0,162,18,0,162
95188,1063533831,163773.0,245.0,55,45,7,48
95189,1063533810,0.0,0.0,7,5,0,7
95203,1063533646,196711.0,30.0,16,6,4,12
95204,1063533645,211157.0,74.0,68,29,6,62
95209,1063533995,0.0,0.0,3,1,0,3
95210,1063533999,13661.0,268.0,21,6,6,15
95217,1063534002,75807.0,38.0,20,13,3,17
95219,1063534006,0.0,38.0,50,35,0,50
95221,1063534128,35904.0,157.0,125,20,6,119
95224,1063533451,32652.0,65.0,106,38,5,101
95226,1063533448,12078.0,35.0,40,17,7,33
95228,1063534123,1942.0,23.0,105,11,2,103
95229,1063533438,43758.0,89.0,24,16,8,16
95230,1063534112,181131.0,108.0,39,13,8,31
95231,1063533432,14303.0,37.0,12,4,7,5
95232,1063534102,12528.0,113.0,20,5,5,15
95233,1063533429,0.0,0.0,3,0,0,3
95234,1063534089,158038.0,265.0,71,24,9,62
95235,1063533425,16064.0,23.0,3,1,1,2
95236,1063534081,21646.0,17.0,34,8,2,32
95251,1063551547,1432.0,7.0,2,1,1,1
95252,1063533421,28217.0,81.0,23,9,10,13
95258,1063533498,82712.0,102.0,36,30,5,31
95260,1063533406,131979.0,137.0,138,67,10,128
95261,1063533760,17555.0,6.0,57,15,2,55
95280,1063533632,197353.0,55.0,35,20,7,28
95283,1063533462,3978.0,51.0,77,23,2,75
95295,1063533543,715.0,11.0,27,11,1,26
95297,1063533547,11932.0,69.0,37,20,5,32
95301,1063533554,715.0,9.0,16,7,1,15
95304,1063533555,22475.0,204.0,50,11,5,45
95305,1063533365,955.0,342.0,125,64,1,124
95307,1063533536,0.0,3.0,10,6,0,10
95311,1063533560,715.0,132.0,130,13,1,129
95312,1063533565,715.0,13.0,37,15,1,36
95313,1063533531,100639.0,61.0,16,4,7,9
95335,1063534825,10407.0,63.0,33,16,3,30
95344,1063533727,12414.0,27.0,8,4,3,5
95345,1063533744,16899.0,38.0,46,19,3,43
95346,1063533759,0.0,0.0,14,8,0,14
95376,1063534152,87121.0,464.0,109,45,16,93
95377,1063533794,61819.0,87.0,36,11,7,29
95380,1063533789,68378.0,38.0,70,48,2,68
95382,1063533788,9103.0,63.0,43,19,5,38
95384,1063533787,22442.0,71.0,15,8,1,14
95389,1063534075,202407.0,93.0,97,35,8,89
95391,1063533653,66038.0,58.0,42,14,4,38
95404,1063533655,17349.0,22.0,13,2,2,11
95414,1063533660,34264.0,60.0,32,17,4,28
95417,1063533674,11153.0,43.0,5,2,3,2
95418,1063533675,24986.0,34.0,19,6,3,16
95428,1063534045,12173.0,88.0,29,18,5,24
95430,1063534042,40145.0,200.0,12,9,6,6
95431,1063533739,102469.0,101.0,60,27,9,51
95432,1063533846,0.0,1.0,12,10,0,12
95434,1063534031,40193.0,115.0,41,22,7,34
95435,1063551552,37947.0,254.0,57,30,19,38
95439,1063533728,911.0,35.0,9,3,1,8
95440,1063533590,0.0,31.0,41,24,0,41
95441,1063534030,121720.0,258.0,121,46,7,114
95443,1063533686,48925.0,138.0,39,10,4,35
95448,1063533683,19058.0,21.0,7,1,2,5
95466,1063533763,70211.0,127.0,68,39,5,63
95471,1063533603,27675.0,58.0,6,2,1,5
95473,1063534149,78038.0,93.0,87,46,6,81
95477,1063534652,9959.0,7.0,10,2,1,9
95491,1063533781,6250.0,16.0,11,6,1,10
95493,1063534026,7606.0,29.0,25,14,3,22
95546,1063534263,2016.0,50.0,17,3,4,13
95547,1063534260,7094.0,62.0,20,7,4,16
95551,1063533648,7411.0,54.0,52,19,3,49
95566,1063534257,5778.0,63.0,14,11,1,13
95567,1063534249,10183.0,83.0,13,7,2,11
95569,1063533598,25181.0,271.0,46,13,13,33
95577,1063534216,0.0,0.0,4,1,0,4
95579,1063533607,179882.0,286.0,114,90,15,99
95604,1063534268,14820.0,50.0,12,5,3,9
95605,1063534146,2636.0,13.0,27,6,2,25
95620,1063533631,0.0,0.0,2,1,0,2
95622,1063533954,1585.0,24.0,81,22,1,80
95624,1063534290,3480.0,8.0,17,9,1,16
95626,1063533950,27988.0,57.0,56,12,3,53
95629,1063533946,0.0,7.0,22,9,0,22
95632,1063533942,1041.0,21.0,31,11,2,29
95634,1063534189,8996.0,11.0,3,0,1,2
95639,1063534185,20332.0,30.0,5,2,2,3
95642,1063534175,22700.0,143.0,13,3,3,10
95643,1063533777,3006.0,11.0,2,1,1,1
95646,1063534172,0.0,4.0,3,0,0,3
95647,1063533774,15860.0,80.0,11,3,5,6
95648,1063533770,6507.0,65.0,20,6,2,18
95649,1063534163,63421.0,41.0,11,2,3,8
95650,1063533768,11764.0,212.0,6,3,3,3
95654,1063533841,35375.0,144.0,7,4,4,3
95655,1063533938,20910.0,159.0,46,20,3,43
95657,1063533766,6076.0,77.0,61,16,2,59
95659,1063533926,20631.0,27.0,19,10,2,17
95661,1063534323,14223.0,82.0,18,15,1,17
95662,1063534321,15215.0,104.0,23,11,2,21
95663,1063534320,71045.0,222.0,20,8,10,10
95672,1063533892,63284.0,17.0,4,2,1,3
95674,1063533871,112874.0,110.0,44,25,5,39
95675,1063533869,113449.0,41.0,30,20,3,27
95676,1063533861,1471.0,11.0,3,1,1,2
95698,1063533904,0.0,13.0,21,8,0,21
95699,1063534581,45267.0,203.0,36,28,4,32
95703,1063533880,93321.0,89.0,21,10,6,15
95704,1063533969,3287.0,79.0,44,14,3,41
95706,1063533971,13795.0,54.0,31,16,3,28
95708,1063533983,25491.0,161.0,55,19,13,42
95711,1063533989,8187.0,251.0,67,29,2,65
95714,1063533990,89938.0,38.0,38,17,3,35
95715,1063533992,34749.0,25.0,42,18,2,40
95719,1063534001,5024.0,40.0,33,20,2,31
95720,1063534019,1552.0,15.0,20,9,1,19
95723,1063533962,16625.0,34.0,26,19,4,22
95724,1063533965,28254.0,54.0,6,4,3,3
95725,1063533959,14372.0,152.0,36,27,3,33
95731,1063534227,10657.0,68.0,49,35,4,45
95748,1063534139,40401.0,77.0,13,2,8,5
95757,1063533925,0.0,0.0,7,5,0,7
95758,1063533912,0.0,19.0,24,14,0,24
95789,1063534012,6009.0,14.0,14,6,2,12
95827,1063534500,0.0,1.0,40,7,0,40
95828,1063534482,27567.0,199.0,31,21,5,26
95863,1063533963,4179.0,10.0,5,4,1,4
95868,1063534231,15541.0,23.0,22,14,1,21
95877,1063534279,4068.0,42.0,28,15,1,27
95907,1063534313,45171.0,146.0,49,38,5,44
95915,1063534310,3558.0,72.0,50,32,2,48
95972,1063534601,59975.0,20.0,96,54,3,93
95980,1063534471,2635.0,9.0,34,6,1,33
95990,1063534244,126980.0,150.0,52,29,10,42
96049,1063535451,21450.0,185.0,63,17,6,57
96121,1063534274,0.0,1.0,7,6,0,7
96156,1063534574,4723.0,32.0,66,38,2,64
96157,1063534569,14093.0,54.0,68,34,2,66
96163,1063534565,20008.0,100.0,18,10,2,16
96165,1063534410,13210.0,33.0,38,22,2,36
96169,1063534342,90390.0,41.0,30,26,4,26
96170,1063534334,18348.0,169.0,94,49,8,86
96172,1063534333,4653.0,11.0,30,22,2,28
96191,1063542094,7116.0,3.0,31,22,1,30
96192,1063534874,6435.0,20.0,26,14,1,25
96193,1063534870,8157.0,30.0,65,34,1,64
96195,1063534868,0.0,0.0,16,10,0,16
96209,1063534327,1921.0,48.0,50,14,2,48
96222,1063534443,12420.0,8.0,7,3,1,6
96228,1063535340,31729.0,195.0,51,29,13,38
96239,1063534396,20786.0,60.0,46,17,5,41
96241,1063534385,23255.0,81.0,31,14,6,25
96245,1063534367,83022.0,93.0,57,42,6,51
96247,1063534363,19070.0,41.0,21,10,4,17
96249,1063534361,101389.0,153.0,30,20,10,20
96250,1063534359,8880.0,10.0,16,12,1,15
96253,1063534355,45590.0,480.0,55,19,5,50
96273,1063534353,13537.0,56.0,10,4,4,6
96305,1063534729,4842.0,87.0,23,9,2,21
96317,1063534324,76740.0,72.0,111,44,12,99
96341,1063534560,55960.0,54.0,59,41,4,55
96343,1063534555,51423.0,167.0,39,20,5,34
96435,1063534646,0.0,0.0,15,12,0,15
96436,1063534720,35802.0,176.0,48,28,7,41
96442,1063534866,7508.0,17.0,14,11,2,12
96455,1063534862,42454.0,181.0,32,17,12,20
96456,1063534711,55981.0,101.0,36,13,7,29
96484,1063534639,59438.0,42.0,76,43,3,73
96488,1063534634,85009.0,84.0,74,46,6,68
96501,1063534629,3113.0,58.0,64,9,2,62
96519,1063534624,1619.0,7.0,16,8,1,15
96526,1063534550,0.0,3.0,20,8,0,20
96529,1063534548,0.0,6.0,57,25,0,57
96533,1063534543,41128.0,38.0,42,24,1,41
96535,1063534536,13501.0,51.0,30,17,4,26
96537,1063534534,30337.0,80.0,43,12,4,39
96539,1063534527,5461.0,9.0,40,19,1,39
96556,1063534513,319.0,9.0,55,27,1,54
96559,1063534509,0.0,0.0,3,1,0,3
96569,1063534501,4517.0,130.0,48,18,1,47
96573,1063534491,61859.0,48.0,22,8,2,20
96574,1063534622,0.0,9.0,29,10,0,29
96575,1063534474,12477.0,151.0,40,26,2,38
96590,1063534421,2551.0,72.0,12,5,2,10
96595,1063534451,26107.0,47.0,114,46,3,111
96598,1063534417,25049.0,187.0,46,25,4,42
96612,1063534901,0.0,0.0,1,0,0,1
96613,1063534893,17840.0,70.0,118,4,4,114
96617,1063534579,25467.0,70.0,74,51,4,70
96620,1063534577,6851.0,158.0,72,37,5,67
96644,1063534775,9910.0,201.0,16,14,4,12
96645,1063534774,0.0,0.0,1,0,0,1
96657,1063534888,3297.0,87.0,10,4,2,8
96675,1063535771,38835.0,67.0,36,24,3,33
96676,1063534885,72991.0,30.0,12,5,6,6
96680,1063535767,252.0,45.0,12,7,1,11
96699,1063535147,11196.0,280.0,40,12,2,38
96701,1063536389,0.0,0.0,32,11,0,32
96738,1063534699,22972.0,95.0,29,12,4,25
96740,1063534695,4027.0,29.0,13,4,2,11
96760,1063534793,7987.0,94.0,33,21,3,30
96785,1063535908,65256.0,95.0,67,41,2,65
96786,1063535898,61156.0,105.0,8,5,5,3
96788,1063535003,7807.0,14.0,11,9,2,9
96790,1063535008,23150.0,178.0,40,22,6,34
96794,1063534994,19489.0,39.0,12,4,3,9
96795,1063534673,19209.0,245.0,53,12,5,48
96799,1063535328,19369.0,157.0,33,25,5,28
96805,1063535325,37497.0,133.0,91,66,8,83
96808,1063534667,20884.0,44.0,35,28,3,32
96809,1063534662,21199.0,78.0,63,21,6,57
96812,1063534656,20939.0,29.0,41,30,2,39
96841,1063534823,5202.0,173.0,16,9,2,14
96842,1063534812,31923.0,97.0,29,4,5,24
96845,1063534805,10883.0,25.0,23,18,3,20
96906,1063534835,33440.0,94.0,48,22,7,41
96907,1063534831,1143.0,114.0,56,40,2,54
96924,1063534847,92443.0,437.0,135,78,9,126
96926,1063534854,10338.0,24.0,24,16,1,23
96940,1063534610,0.0,3.0,19,5,0,19
96949,1063534883,5555.0,23.0,28,8,2,26
96950,1063534780,36930.0,239.0,106,55,7,99
96951,1063534790,273714.0,192.0,144,67,9,135
96954,1063535104,1823.0,184.0,63,40,1,62
96955,1063534787,24543.0,122.0,51,37,5,46
96957,1063535089,12682.0,37.0,45,27,2,43
96958,1063535099,15243.0,141.0,77,24,3,74
96960,1063535080,1853.0,5.0,12,11,2,10
96961,1063551567,60980.0,91.0,63,27,5,58
96962,1063535224,51377.0,160.0,44,15,7,37
96963,1063534783,175052.0,172.0,120,70,6,114
96964,1063535094,71603.0,287.0,68,33,10,58
96965,1063535220,20934.0,96.0,10,3,4,6
96966,1063535212,30367.0,108.0,26,14,7,19
96969,1063534607,12854.0,50.0,15,10,6,9
96975,1063535130,22514.0,13.0,30,24,2,28
96992,1063534771,2520.0,33.0,10,3,1,9
96993,1063534765,616.0,3.0,9,3,1,8
97000,1063534655,2293.0,9.0,10,1,2,8
97061,1063538203,64184.0,72.0,51,27,3,48
97062,1063538194,86856.0,363.0,58,21,12,46
97072,1063538185,162728.0,146.0,80,44,10,70
97081,1063538183,70698.0,89.0,36,18,6,30
97086,1063534982,9895.0,17.0,13,4,2,11
97091,1063534749,34918.0,33.0,26,17,3,23
97093,1063535823,19506.0,103.0,15,8,5,10
97097,1063534745,3683.0,62.0,15,8,4,11
97098,1063534743,5093.0,105.0,21,7,2,19
97100,1063534739,14500.0,129.0,52,21,2,50
97101,1063534759,15819.0,9.0,6,3,1,5
97102,1063534735,0.0,0.0,4,3,0,4
97103,1063535821,38848.0,86.0,15,7,7,8
97110,1063535815,30611.0,162.0,29,10,11,18
97111,1063535129,84059.0,211.0,47,34,7,40
97119,1063535116,0.0,0.0,4,2,0,4
97120,1063541356,94826.0,151.0,423,34,10,413
97133,1063534682,94674.0,77.0,89,46,5,84
97137,1063534971,55300.0,112.0,99,56,6,93
97141,1063534958,26059.0,31.0,31,15,8,23
97142,1063534929,1932.0,32.0,12,10,2,10
97162,1063534905,0.0,2.0,11,4,0,11
97194,1063535317,23679.0,50.0,18,13,2,16
97209,1063535450,97325.0,77.0,67,13,4,63
97213,1063535445,39067.0,113.0,92,21,3,89
97216,1063535073,49389.0,227.0,46,17,4,42
97218,1063535069,734.0,15.0,18,11,1,17
97219,1063535443,59338.0,144.0,54,14,6,48
97226,1063534859,38525.0,69.0,15,7,4,11
97229,1063535850,17832.0,33.0,23,9,3,20
97247,1063535809,772.0,60.0,13,7,2,11
97264,1063535435,39548.0,71.0,56,21,7,49
97267,1063534922,3259.0,29.0,11,7,2,9
97269,1063535063,0.0,13.0,136,73,0,136
97272,1063535836,0.0,9.0,51,41,0,51
97274,1063536188,11618.0,121.0,38,21,5,33
97276,1063535050,58425.0,153.0,59,29,17,42
97279,1063535049,14745.0,112.0,332,86,5,327
97300,1063535401,2552.0,7.0,7,4,1,6
97315,1063535802,0.0,0.0,2,0,0,2
97393,1063551560,2960.0,115.0,6,2,2,4
97413,1063535045,23185.0,25.0,115,79,1,114
97415,1063534976,0.0,0.0,20,3,0,20
97416,1063536328,33773.0,74.0,66,26,5,61
97426,1063535376,62802.0,63.0,23,4,5,18
97429,1063535369,42732.0,44.0,29,17,3,26
97431,1063535349,100412.0,177.0,102,61,9,93
97432,1063551570,9423.0,78.0,38,15,4,34
97532,1063535313,5271.0,24.0,6,4,2,4
97538,1063535394,2294.0,37.0,10,4,3,7
97539,1063535391,48706.0,46.0,35,8,3,32
97541,1063535386,29540.0,102.0,13,5,6,7
97545,1063535486,117750.0,50.0,42,27,3,39
97546,1063535434,2284.0,35.0,31,18,1,30
97548,1063535190,26313.0,227.0,74,14,22,52
97550,1063535184,0.0,6.0,14,6,0,14
97551,1063535429,6442.0,115.0,34,23,4,30
97552,1063535152,111882.0,96.0,31,14,10,21
97555,1063535192,17012.0,43.0,23,4,6,17
97557,1063535423,6729.0,10.0,42,27,1,41
97559,1063536352,0.0,0.0,20,9,0,20
97560,1063535193,94990.0,485.0,103,35,11,92
97564,1063535198,0.0,2.0,50,17,0,50
97567,1063536347,15772.0,22.0,5,4,3,2
97568,1063535179,42718.0,128.0,40,24,5,35
97569,1063535880,5227.0,111.0,30,13,3,27
97571,1063535175,14478.0,242.0,30,15,5,25
97572,1063535878,42217.0,130.0,55,36,3,52
97574,1063535868,15468.0,124.0,18,7,6,12
97575,1063535864,0.0,4.0,13,7,0,13
97576,1063535862,78104.0,137.0,34,17,5,29
97588,1063535418,29438.0,35.0,75,39,3,72
97592,1063535115,6502.0,41.0,9,7,1,8
97649,1063535037,85748.0,116.0,36,7,15,21
97650,1063535018,17653.0,30.0,45,21,3,42
97678,1063535409,3179.0,18.0,120,93,4,116
97709,1063542101,28354.0,70.0,51,37,4,47
97715,1063535483,39221.0,94.0,76,56,4,72
97743,1063535998,23565.0,76.0,40,31,5,35
97750,1063535348,4320.0,7.0,6,2,1,5
97757,1063535249,11919.0,450.0,77,15,3,74
97759,1063535243,33685.0,43.0,37,25,2,35
97765,1063535231,11268.0,18.0,69,35,1,68
97770,1063535470,14034.0,87.0,51,31,5,46
97777,1063535731,158814.0,281.0,164,32,8,156
97778,1063535991,32342.0,54.0,29,9,2,27
97780,1063535724,140729.0,125.0,84,56,9,75
97781,1063535583,138444.0,181.0,38,27,9,29
97782,1063536341,17108.0,48.0,24,8,2,22
97788,1063535575,5942.0,11.0,34,23,1,33
97789,1063535984,18174.0,174.0,22,12,7,15
97791,1063535974,73441.0,73.0,36,23,7,29
97793,1063535565,46044.0,232.0,19,14,5,14
97794,1063535259,69632.0,37.0,28,17,3,25
97796,1063535269,0.0,1.0,5,3,0,5
97797,1063535971,92339.0,156.0,22,12,4,18
97798,1063535562,8478.0,27.0,35,28,1,34
97799,1063535278,5729.0,120.0,24,15,3,21
97803,1063535307,12477.0,15.0,99,14,1,98
97804,1063535173,14929.0,173.0,29,18,3,26
97805,1063535229,30802.0,42.0,39,34,2,37
97806,1063535310,30619.0,80.0,38,19,5,33
97807,1063535200,79403.0,133.0,21,10,8,13
97809,1063535253,19237.0,112.0,16,7,6,10
97820,1063535542,1780.0,45.0,54,38,2,52
97830,1063535859,18151.0,52.0,19,8,3,16
97838,1063536268,3496.0,41.0,42,19,2,40
97841,1063536261,0.0,0.0,7,2,0,7
97842,1063536251,13791.0,74.0,19,11,2,17
97844,1063536247,1410.0,17.0,5,2,2,3
97849,1063536238,18730.0,33.0,10,5,2,8
97858,1063535833,44301.0,22.0,25,9,1,24
97859,1063535831,3112.0,25.0,9,5,2,7
97864,1063535824,9867.0,72.0,17,3,2,15
97895,1063535226,1151.0,236.0,28,10,4,24
97904,1063535384,2508.0,24.0,6,5,1,5
97926,1063535533,4799.0,26.0,15,10,2,13
97941,1063535757,15202.0,128.0,117,41,4,113
97949,1063535524,24843.0,35.0,65,51,4,61
97953,1063535517,0.0,2.0,11,9,0,11
97977,1063535209,102570.0,270.0,45,28,13,32
98047,1063535884,18666.0,73.0,51,38,6,45
98062,1063535753,9761.0,98.0,11,4,3,8
98075,1063535380,32415.0,41.0,22,5,2,20
98096,1063535397,21978.0,120.0,22,10,3,19
98101,1063535321,0.0,2.0,11,6,0,11
98102,1063535663,89307.0,68.0,34,25,4,30
98105,1063535649,0.0,4.0,11,4,0,11
98106,1063535636,22738.0,72.0,27,17,3,24
98119,1063535632,7536.0,34.0,26,19,2,24
98124,1063535626,6244.0,42.0,56,45,3,53
98125,1063535509,12958.0,32.0,67,50,1,66
98131,1063535622,26978.0,168.0,24,19,6,18
98215,1063535499,15150.0,116.0,69,27,7,62
98226,1063535492,0.0,9.0,32,29,0,32
98236,1063536181,47943.0,103.0,36,23,3,33
98276,1063535720,40280.0,57.0,19,9,6,13
98281,1063535615,15529.0,20.0,23,21,4,19
98285,1063535713,9347.0,19.0,96,58,2,94
98286,1063535604,2184.0,77.0,30,28,2,28
98288,1063535707,82190.0,132.0,34,13,7,27
98289,1063535886,40905.0,202.0,38,23,4,34
98333,1063535799,7589.0,12.0,6,2,2,4
98335,1063535795,2088.0,157.0,15,1,4,11
98339,1063535794,41126.0,149.0,30,19,5,25
98366,1063535782,1146.0,29.0,71,44,1,70
98374,1063536176,657.0,42.0,15,10,1,14
98384,1063535601,0.0,0.0,1,0,0,1
98391,1063535346,45536.0,159.0,44,30,6,38
98412,1063535890,45895.0,238.0,29,17,10,19
98434,1063535894,0.0,25.0,21,13,0,21
98436,1063535598,10109.0,132.0,29,25,3,26
98437,1063535594,782.0,1.0,13,5,1,12
98439,1063535590,0.0,4.0,13,9,0,13
98441,1063535701,18087.0,177.0,37,25,6,31
98443,1063535699,1064605.0,440.0,114,39,21,93
98444,1063535692,14114.0,199.0,47,37,5,42
98445,1063535673,29444.0,277.0,48,29,3,45
98452,1063535851,1534.0,4.0,15,11,1,14
98460,1063535671,74762.0,125.0,36,25,6,30
98482,1063536417,46601.0,135.0,66,44,6,60
98483,1063537683,14540.0,9.0,45,29,2,43
98489,1063536231,9848.0,24.0,3,1,1,2
98544,1063535961,25140.0,55.0,38,19,2,36
98545,1063535957,88357.0,68.0,40,23,5,35
98548,1063535943,45163.0,263.0,134,42,7,127
98549,1063535933,104234.0,161.0,50,25,12,38
98550,1063535928,73603.0,152.0,104,45,11,93
98553,1063536077,10350.0,46.0,37,24,4,33
98554,1063535923,160284.0,170.0,69,52,6,63
98555,1063535487,904.0,13.0,30,24,1,29
98557,1063535917,63009.0,79.0,46,24,6,40
98558,1063535913,207768.0,380.0,83,43,19,64
98564,1063536072,3514.0,15.0,21,11,3,18
98567,1063536062,1998.0,54.0,322,21,1,321
98568,1063536004,5865.0,50.0,23,16,3,20
98569,1063536056,0.0,7.0,26,15,0,26
98572,1063536051,45291.0,164.0,80,44,11,69
98581,1063535911,10615.0,208.0,30,10,5,25
98582,1063535456,53645.0,266.0,58,33,5,53
98584,1063536520,0.0,5.0,9,2,0,9
98587,1063536505,12623.0,72.0,30,14,3,27
98597,1063536792,0.0,1.0,3,0,0,3
98624,1063536488,36183.0,96.0,47,20,6,41
98632,1063537102,3995.0,32.0,34,13,2,32
98682,1063536379,7045.0,34.0,11,6,2,9
98691,1063536503,28295.0,136.0,35,20,7,28
98706,1063536370,30079.0,112.0,59,34,7,52
98707,1063536149,11898.0,160.0,40,28,4,36
98714,1063536139,0.0,2.0,16,10,0,16
98728,1063536130,16618.0,163.0,37,30,4,33
98732,1063537649,12473.0,28.0,8,4,3,5
98735,1063536101,20792.0,102.0,70,49,3,67
98740,1063536097,10732.0,71.0,46,32,3,43
98773,1063535748,9594.0,53.0,9,4,1,8
98814,1063536218,12057.0,37.0,40,24,2,38
98815,1063536213,6697.0,29.0,74,49,2,72
98820,1063536212,36011.0,76.0,117,74,9,108
98822,1063536364,32428.0,82.0,18,4,5,13
98824,1063536093,3902.0,80.0,48,40,2,46
98845,1063536203,52086.0,96.0,68,52,7,61
98847,1063536199,38296.0,150.0,53,26,7,46
98849,1063536414,33629.0,11.0,2,1,1,1
98861,1063536413,68426.0,48.0,15,8,2,13
98865,1063536409,51488.0,58.0,34,11,3,31
98868,1063536403,48319.0,51.0,44,22,4,40
98871,1063536272,26295.0,118.0,58,37,6,52
98872,1063536269,938.0,32.0,23,8,1,22
98876,1063536872,262238.0,400.0,84,14,20,64
98885,1063536172,0.0,0.0,12,7,0,12
98888,1063536085,33562.0,153.0,112,64,4,108
98890,1063536197,32384.0,158.0,98,65,7,91
98894,1063536320,0.0,20.0,14,4,0,14
98907,1063536516,0.0,0.0,18,7,0,18
98914,1063536305,1111.0,36.0,60,11,3,57
98934,1063536362,22964.0,73.0,15,5,4,11
98940,1063537082,143236.0,470.0,56,27,11,45
98941,1063536300,0.0,3.0,43,32,0,43
98956,1063536294,10103.0,7.0,3,2,1,2
98961,1063536293,16302.0,41.0,14,8,4,10
98968,1063536767,26679.0,71.0,48,31,4,44
98983,1063536761,8767.0,26.0,38,30,1,37
98988,1063536759,19857.0,26.0,21,12,4,17
98990,1063536756,28703.0,37.0,26,15,4,22
98991,1063536753,31824.0,123.0,21,5,9,12
98992,1063536167,51418.0,71.0,17,6,11,6
98994,1063536742,1816.0,42.0,39,23,2,37
99009,1063536740,10962.0,11.0,27,24,1,26
99012,1063536734,117332.0,72.0,46,21,5,41
99026,1063536047,818.0,5.0,50,22,1,49
99029,1063536281,0.0,0.0,3,2,0,3
99030,1063536036,9301.0,32.0,37,4,1,36
99034,1063536021,8895.0,84.0,7,5,1,6
99039,1063536018,15152.0,157.0,33,28,5,28
99042,1063536013,0.0,246.0,9,0,0,9
99043,1063536357,120640.0,161.0,199,46,5,194
99044,1063536010,15677.0,184.0,174,35,3,171
99082,1063536397,41418.0,21.0,34,12,2,32
99098,1063537478,27173.0,69.0,51,22,6,45
99102,1063537481,14723.0,37.0,28,10,4,24
99104,1063537473,3678.0,149.0,23,18,1,22
99107,1063537464,20079.0,112.0,38,19,5,33
99115,1063537421,51243.0,14.0,19,14,2,17
99132,1063536725,12636.0,57.0,59,27,2,57
99145,1063537119,96467.0,241.0,52,31,7,45
99151,1063537169,60324.0,200.0,38,19,9,29
99172,1063538532,42248.0,88.0,119,44,6,113
99189,1063538523,27005.0,96.0,10,4,5,5
99215,1063537878,34242.0,50.0,25,15,8,17
99216,1063536554,174357.0,136.0,48,34,7,41
99217,1063536546,85960.0,16.0,22,10,2,20
99220,1063536536,109968.0,180.0,84,56,6,78
99223,1063536533,6000.0,8.0,6,5,1,5
99228,1063536600,19810.0,53.0,17,9,2,15
99230,1063536597,374.0,1.0,57,47,1,56
99240,1063536589,31136.0,109.0,56,37,3,53
99256,1063536426,25220.0,38.0,65,19,5,60
99260,1063536571,12193.0,90.0,53,38,2,51
99264,1063538175,67575.0,114.0,38,29,6,32
99265,1063538171,167608.0,84.0,33,18,5,28
99268,1063536569,15867.0,52.0,57,36,5,52
99269,1063538165,134887.0,189.0,41,15,9,32
99271,1063536336,9423.0,40.0,14,9,3,11
99277,1063538515,41714.0,48.0,17,6,4,13
99299,1063536525,7615.0,32.0,25,2,4,21
99314,1063536527,5175.0,22.0,6,3,1,5
99317,1063536817,62939.0,28.0,33,18,2,31
99320,1063536821,47865.0,40.0,10,6,7,3
99330,1063536867,7506.0,74.0,18,5,4,14
99332,1063536823,65052.0,185.0,58,8,9,49
99334,1063536833,79521.0,87.0,13,7,4,9
99335,1063536802,260312.0,211.0,56,13,18,38
99337,1063536837,82144.0,59.0,20,7,5,15
99344,1063536479,0.0,5.0,19,8,0,19
99357,1063536465,15766.0,23.0,20,9,3,17
99358,1063536452,0.0,1.0,32,6,0,32
99360,1063536443,7224.0,378.0,375,21,2,373
99361,1063536435,5772.0,12.0,13,7,2,11
99362,1063536432,12940.0,19.0,20,11,1,19
99369,1063536559,0.0,6.0,16,9,0,16
99371,1063536604,25615.0,32.0,29,23,2,27
99372,1063536611,0.0,10.0,20,13,0,20
99373,1063538182,22737.0,70.0,21,1,3,18
99374,1063536614,7491.0,6.0,22,16,1,21
99375,1063536530,181250.0,88.0,23,14,9,14
99376,1063536529,9851.0,9.0,34,9,4,30
99377,1063536616,590.0,3.0,9,4,1,8
99378,1063537415,3324.0,32.0,14,4,1,13
99390,1063537681,60036.0,37.0,15,6,6,9
99392,1063537676,8260.0,14.0,10,8,2,8
99404,1063536697,6387.0,67.0,28,8,4,24
99405,1063536680,27602.0,34.0,26,23,3,23
99406,1063536663,49529.0,274.0,801,18,9,792
99408,1063537073,20737.0,15.0,14,8,1,13
99411,1063536640,19788.0,75.0,30,21,7,23
99432,1063536632,6380.0,33.0,7,4,1,6
99434,1063536628,0.0,7.0,75,10,0,75
99435,1063536480,11470.0,27.0,4,2,2,2
99449,1063536715,1088.0,94.0,18,0,1,17
99460,1063537669,75974.0,95.0,23,9,9,14
99461,1063536707,133288.0,47.0,18,8,2,16
99462,1063537667,3162.0,80.0,19,7,3,16
99466,1063538600,4514.0,24.0,26,13,1,25
99467,1063538599,55610.0,94.0,44,21,7,37
99468,1063538585,17750.0,33.0,39,15,4,35
99475,1063536623,2488.0,96.0,17,4,4,13
99483,1063536481,8362.0,6.0,17,7,1,16
99485,1063536704,2486.0,28.0,15,7,3,12
99488,1063536701,1530.0,48.0,6,1,2,4
99493,1063538580,3540.0,66.0,53,17,1,52
99614,1063537265,12704.0,69.0,44,21,3,41
99615,1063537258,59784.0,144.0,59,31,9,50
99616,1063537248,9125.0,44.0,19,8,3,16
99618,1063537245,13564.0,25.0,19,10,3,16
99621,1063537233,20932.0,18.0,44,19,3,41
99630,1063537127,3510.0,32.0,7,3,1,6
99724,1063536732,48850.0,162.0,58,36,5,53
99735,1063537619,0.0,2.0,10,3,0,10
99737,1063537636,15030.0,39.0,106,45,3,103
99739,1063537630,68387.0,142.0,58,17,11,47
99743,1063537606,47982.0,142.0,24,18,6,18
99744,1063537625,68246.0,224.0,47,17,10,37
99762,1063536781,26428.0,33.0,33,25,4,29
99765,1063538938,103747.0,64.0,34,6,4,30
99777,1063538399,57103.0,236.0,37,25,10,27
99787,1063538397,37954.0,120.0,85,35,3,82
99815,1063538392,27450.0,58.0,22,11,4,18
99816,1063536790,40272.0,81.0,44,11,13,31
99824,1063537030,48996.0,128.0,59,29,5,54
99826,1063537055,16272.0,97.0,33,22,6,27
99830,1063537853,83700.0,57.0,17,11,3,14
99831,1063537053,20563.0,358.0,55,34,7,48
99833,1063537058,45084.0,125.0,15,10,5,10
99834,1063537875,10282.0,70.0,11,7,4,7
99842,1063537485,25783.0,144.0,38,17,7,31
99845,1063537342,98.0,38.0,9,3,1,8
99849,1063537355,0.0,8.0,14,6,0,14
99851,1063537346,3041.0,9.0,17,6,1,16
99852,1063537336,8862.0,41.0,24,7,3,21
99854,1063537150,9581.0,10.0,38,16,3,35
99861,1063537601,9794.0,28.0,32,20,3,29
99862,1063537599,18178.0,86.0,67,19,5,62
99865,1063537593,36250.0,50.0,13,6,2,11
99868,1063537519,25833.0,49.0,8,3,4,4
99870,1063537588,134842.0,108.0,74,51,8,66
99878,1063537584,18344.0,22.0,42,31,3,39
99879,1063537514,5700.0,34.0,17,11,3,14
99880,1063537872,21757.0,92.0,14,8,4,10
99881,1063536973,60793.0,144.0,78,52,7,71
99882,1063537487,6925.0,47.0,18,6,2,16
99887,1063536993,2983.0,87.0,21,5,2,19
99888,1063536965,5430.0,10.0,15,12,1,14
99889,1063536987,5521.0,53.0,64,13,4,60
99890,1063536951,7062.0,231.0,67,31,4,63
99891,1063536946,17091.0,26.0,38,17,2,36
99894,1063537450,68269.0,176.0,37,26,8,29
99895,1063537509,39954.0,151.0,16,11,7,9
99897,1063537443,34104.0,37.0,24,18,5,19
99898,1063537437,48101.0,110.0,39,21,4,35
99902,1063537431,14601.0,94.0,56,38,2,54
99908,1063537023,51626.0,96.0,32,20,6,26
99909,1063537018,11109.0,74.0,42,24,2,40
99910,1063537015,23175.0,86.0,71,56,6,65
99911,1063537012,11109.0,25.0,20,14,1,19
99912,1063537011,2089.0,1.0,3,0,1,2
99913,1063537008,34256.0,206.0,35,2,3,32
99914,1063537001,7009.0,65.0,24,17,4,20
99917,1063537002,193527.0,190.0,68,33,13,55
99939,1063536932,0.0,31.0,34,16,0,34
99956,1063537865,38.0,8.0,14,6,1,13
99957,1063537309,1582.0,2.0,12,5,1,11
99961,1063537576,18445.0,155.0,84,35,11,73
99963,1063537752,86125.0,197.0,64,23,14,50
99966,1063536926,0.0,8.0,43,26,0,43
99973,1063536922,1011.0,305.0,30,18,1,29
99975,1063536908,96444.0,60.0,24,17,7,17
99987,1063536982,15089.0,24.0,14,3,1,13
99993,1063536980,18688.0,60.0,65,13,3,62
